Tender ID,Material Cost,Labor Cost,Equipment Cost,Overheads,Sustainability Investments,Total Project Cost,Sustainability Score,Predicted Environmental Impact
Tender_1,674171,3399987,1510457,403521,81027,6069163,31.0,6.9
Tender_2,4537959,3239693,1607045,439475,412748,10236920,43.67,5.63
Tender_3,1122613,4444312,1690956,666638,444507,8369026,49.33,5.07
Tender_4,5175172,4975110,1227691,289486,128605,11796064,28.33,7.17
Tender_5,4695106,1854714,536083,262640,387313,7735856,44.33,5.57
Tender_6,1838612,1779331,2540803,631617,124748,6915111,47.67,5.23
Tender_7,6720960,2148861,2498552,316909,54568,11739850,50.67,4.93
Tender_8,1447824,2942222,2802199,171211,436181,7799637,35.33,6.47
Tender_9,6844021,4100211,71637,657416,208635,11881920,43.67,5.63
Tender_10,7007650,875429,2783896,777753,321849,11766577,40.0,6.0
Tender_11,1839079,3856355,2995034,506512,279580,9476560,28.33,7.17
Tender_12,3575731,3730153,1021120,223896,139045,8689945,36.0,6.4
Tender_13,259941,4688420,2491094,169202,325879,7934536,44.67,5.53
Tender_14,6866800,3121108,2798633,687499,284813,13758853,37.33,6.27
Tender_15,3571563,1712796,2886431,585676,211573,8968039,29.67,7.03
Tender_16,5700890,4359645,2889622,412704,399142,13762003,27.0,7.3
Tender_17,4966340,2374269,1960500,822622,167816,10291547,56.0,4.4
Tender_18,9027703,2367384,90327,769796,392045,12647255,57.0,4.3
Tender_19,6062751,284376,2625793,824700,372753,10170373,26.0,7.4
Tender_20,3451763,4489493,2057091,870560,197924,11066831,49.33,5.07
Tender_21,9820241,2366006,209210,706745,149572,13251774,35.33,6.47
Tender_22,7235689,3893520,1304173,175397,411666,13020445,36.33,6.37
Tender_23,1678904,3997519,2615319,406225,233596,8931563,27.33,7.27
Tender_24,416039,1338657,642285,441123,342465,3180569,28.67,7.13
Tender_25,5077894,4033117,778154,710559,254557,10854281,37.67,6.23
Tender_26,8839154,3898535,445508,816477,494500,14494174,25.0,7.5
Tender_27,533196,1392807,110458,780450,120729,2937640,28.0,7.2
Tender_28,8840071,4387614,1428559,248352,111804,15016400,40.67,5.93
Tender_29,9627219,303715,1781154,631963,175115,12519166,27.67,7.23
Tender_30,302177,1264822,328873,588469,380349,2864690,44.33,5.57
Tender_31,5476137,4273473,2802580,352111,113642,13017943,38.33,6.17
Tender_32,8227459,3933888,725807,851739,329571,14068464,32.33,6.77
Tender_33,4596495,716994,471054,502701,385553,6672797,48.33,5.17
Tender_34,9975652,2591369,2552631,650499,191751,15961902,43.0,5.7
Tender_35,8970842,103602,2863809,737088,91834,12767175,48.33,5.17
Tender_36,8333537,304318,2715260,523329,426599,12303043,37.33,6.27
Tender_37,6243460,2490048,2411122,415994,343820,11904444,38.0,6.2
Tender_38,9091049,3261611,2474986,916983,498329,16242958,35.0,6.5
Tender_39,4446086,2252225,2065646,748806,70890,9583653,30.33,6.97
Tender_40,1097353,540723,2961192,300133,430073,5329474,21.67,7.83
Tender_41,3039744,4526853,1512966,597643,300550,9977756,46.67,5.33
Tender_42,5234983,4271033,746899,357474,111359,10721748,49.33,5.07
Tender_43,4290725,4645354,1573265,536771,383132,11429247,40.33,5.97
Tender_44,8617056,940037,1101522,279357,283345,11221317,37.67,6.23
Tender_45,7914176,4079537,2081738,454298,344574,14874323,55.33,4.47
Tender_46,1318147,2079242,2866454,407395,76484,6747722,57.0,4.3
Tender_47,3815578,3724240,305924,647011,345698,8838451,35.67,6.43
Tender_48,9233903,1022037,1897608,907312,341148,13402008,32.67,6.73
Tender_49,2587175,4369411,2289172,229666,330478,9805902,31.0,6.9
Tender_50,7891643,4504019,2317776,567862,256063,15537363,37.0,6.3
Tender_51,9730780,2927711,934066,821286,487593,14901436,26.0,7.4
Tender_52,4057756,3875042,1577318,501277,246334,10257727,44.0,5.6
Tender_53,5876162,2981996,2657525,501844,352374,12369901,21.67,7.83
Tender_54,4919054,1348650,2533857,116746,322280,9240587,46.33,5.37
Tender_55,4614751,2369983,1264916,178568,234653,8662871,41.67,5.83
Tender_56,4708658,3149227,1191578,774697,207934,10032094,33.33,6.67
Tender_57,5848091,1453292,1956288,261404,86884,9605959,43.33,5.67
Tender_58,9283547,1059707,585569,156756,308442,11394021,42.0,5.8
Tender_59,590471,3376062,2842647,803847,456967,8069994,36.0,6.4
Tender_60,5936526,2553035,1612454,551828,158255,10812098,37.0,6.3
Tender_61,7542597,1483126,462949,454900,143200,10086772,36.33,6.37
Tender_62,3593114,389824,601116,846717,151627,5582398,28.33,7.17
Tender_63,1243266,882444,2976666,971538,204662,6278576,48.0,5.2
Tender_64,2294067,1030144,557587,177210,389123,4448131,25.0,7.5
Tender_65,5608698,4439554,606713,928552,132826,11716343,50.0,5.0
Tender_66,2418427,522705,135229,395353,224839,3696553,34.0,6.6
Tender_67,6840636,4505980,2358129,828019,115318,14648082,29.0,7.1
Tender_68,1457320,1516469,1755881,990746,153585,5874001,49.67,5.03
Tender_69,4851491,2834687,2682648,706341,314571,11389738,44.33,5.57
Tender_70,6115060,2213877,1567213,777402,468069,11141621,25.67,7.43
Tender_71,7669406,4814152,2986739,575394,278918,16324609,35.67,6.43
Tender_72,8884076,2772882,1394001,835915,111539,13998413,43.0,5.7
Tender_73,3059392,1220814,72778,487949,280202,5121135,23.67,7.63
Tender_74,5150297,802991,2491220,433667,217348,9095523,24.67,7.53
Tender_75,6370067,785585,2438035,821654,387008,10802349,38.67,6.13
Tender_76,6941966,1250541,107585,780983,216194,9297269,23.0,7.7
Tender_77,7323611,1043724,2057598,52521,269229,10746683,37.67,6.23
Tender_78,4030494,3159134,211371,982641,221254,8604894,39.67,6.03
Tender_79,7490677,4936395,487386,335634,83934,13334026,34.67,6.53
Tender_80,3794710,2710240,2635881,792119,291391,10224341,30.67,6.93
Tender_81,988537,3645296,1317711,579365,157043,6687952,37.0,6.3
Tender_82,6218234,2164308,936836,542349,388741,10250468,40.33,5.97
Tender_83,2054048,1679237,65912,110013,405983,4315193,34.67,6.53
Tender_84,2519852,2174302,1590702,986424,376677,7647957,37.33,6.27
Tender_85,8871620,4814767,2685652,960184,185350,17517573,45.0,5.5
Tender_86,1605928,999999,2325914,633456,138478,5703775,39.33,6.07
Tender_87,7099007,4067925,1321188,518511,260282,13266913,39.33,6.07
Tender_88,3478297,4875824,1917161,220160,129496,10620938,29.67,7.03
Tender_89,7546090,4589357,402330,598594,437059,13573430,51.33,4.87
Tender_90,7505514,2217142,1729623,720225,66718,12239222,36.67,6.33
Tender_91,4034929,1337387,945596,349230,388094,7055236,48.67,5.13
Tender_92,1697592,3772606,1213734,94678,380448,7159058,29.67,7.03
Tender_93,7928380,3624252,1133714,177550,380825,13244721,52.33,4.77
Tender_94,4265961,477720,554194,62348,271705,5631928,46.33,5.37
Tender_95,3501514,949467,1385801,507871,474592,6819245,53.67,4.63
Tender_96,3532972,4017009,498722,541286,103431,8693420,41.33,5.87
Tender_97,9593256,4018999,1015511,815161,349205,15792132,30.33,6.97
Tender_98,6106708,318066,1679049,787809,203824,9095456,32.67,6.73
Tender_99,6843689,3249316,456353,461039,474184,11484581,53.67,4.63
Tender_100,9442806,534874,2960883,336851,437863,13713277,46.67,5.33
Tender_101,4392454,2865566,698527,957659,165286,9079492,50.67,4.93
Tender_102,6818118,2020876,1339497,709739,188100,11076330,33.33,6.67
Tender_103,9781642,1749193,189010,749698,321828,12791371,45.0,5.5
Tender_104,5793952,4021441,898653,417887,246395,11378328,34.67,6.53
Tender_105,7706125,615549,1834023,741445,136163,11033305,26.33,7.37
Tender_106,865208,1136287,159398,337864,64234,2562991,38.33,6.17
Tender_107,1205900,2081498,567673,84901,454147,4394119,37.0,6.3
Tender_108,2120825,3280636,832520,425437,236997,6896415,41.0,5.9
Tender_109,5723916,2006856,2020182,496275,324601,10571830,49.33,5.07
Tender_110,768456,4485728,2768459,96420,448224,8567287,37.67,6.23
Tender_111,4267111,3510317,2260977,222293,188460,10449158,46.0,5.4
Tender_112,4737723,2945405,810367,950791,288788,9733074,35.33,6.47
Tender_113,3626816,626908,1971446,111143,432433,6768746,31.0,6.9
Tender_114,2204377,2278274,73025,800825,413012,5769513,40.67,5.93
Tender_115,7387472,1916635,2558241,750702,384879,12997929,40.67,5.93
Tender_116,2776367,3522362,480351,116190,486105,7381375,49.33,5.07
Tender_117,3173019,2203873,2108974,598886,50075,8134827,38.33,6.17
Tender_118,3574894,3704948,1836746,513802,332959,9963349,41.33,5.87
Tender_119,5597751,1642195,239799,266375,229881,7976001,32.33,6.77
Tender_120,6996744,4868237,739896,210377,200569,13015823,39.67,6.03
Tender_121,3290165,3296330,2918677,986439,483670,10975281,34.33,6.57
Tender_122,2276462,4897664,1101407,614628,440961,9331122,25.33,7.47
Tender_123,4203338,566202,88852,909739,88158,5856289,45.0,5.5
Tender_124,4593668,2992699,600008,399351,409740,8995466,37.67,6.23
Tender_125,3460703,2717655,2937995,832289,117707,10066349,41.0,5.9
Tender_126,4214765,2957303,1739460,466946,200332,9578806,38.33,6.17
Tender_127,6401470,1611266,1040702,392855,424341,9870634,39.67,6.03
Tender_128,7696553,726099,2954397,977170,192909,12547128,40.33,5.97
Tender_129,1683706,437850,1405609,634478,305809,4467452,37.67,6.23
Tender_130,3102869,4988156,1822507,705412,323716,10942660,48.33,5.17
Tender_131,478235,1495429,2352411,115290,341167,4782532,37.67,6.23
Tender_132,5613934,3418180,2330459,721270,201516,12285359,30.33,6.97
Tender_133,8377302,4077872,1977496,936010,160681,15529361,43.67,5.63
Tender_134,5402542,1142703,2528168,808545,78343,9960301,33.33,6.67
Tender_135,2360473,1666313,1618970,688970,59472,6394198,34.67,6.53
Tender_136,1355293,2776241,1480066,108288,410400,6130288,42.0,5.8
Tender_137,3877591,4605126,715048,417171,466219,10081155,30.0,7.0
Tender_138,9172513,2404940,2458424,862901,444346,15343124,41.33,5.87
Tender_139,7327214,194695,2509695,906406,398761,11336771,49.0,5.1
Tender_140,243708,2575637,445754,708459,494812,4468370,39.0,6.1
Tender_141,6573549,4246391,188338,298225,226722,11533225,32.0,6.8
Tender_142,8659389,3579085,288553,587673,414191,13528891,40.67,5.93
Tender_143,3336537,588819,1733498,65918,58522,5783294,38.33,6.17
Tender_144,9104645,4355708,621591,414892,293502,14790338,37.67,6.23
Tender_145,7763760,2175747,2556506,754960,385479,13636452,42.67,5.73
Tender_146,2433323,326724,330990,282934,469660,3843631,35.0,6.5
Tender_147,8775670,3772365,1827612,332207,150670,14858524,42.33,5.77
Tender_148,7733738,2171307,2567009,490142,220867,13183063,30.67,6.93
Tender_149,757498,2866719,1854027,397693,150733,6026670,35.0,6.5
Tender_150,2582731,2441563,2066193,79807,221936,7392230,22.67,7.73
Tender_151,4432741,3625732,225075,855823,150207,9289578,25.0,7.5
Tender_152,6408359,501876,2280010,262017,143860,9596122,32.67,6.73
Tender_153,6934040,229079,864284,209095,184134,8420632,35.0,6.5
Tender_154,5395212,4192038,645665,356897,211918,10801730,49.0,5.1
Tender_155,5691844,4975898,1016252,794962,182049,12661005,38.33,6.17
Tender_156,4113596,3960176,2327256,75004,370734,10846766,39.33,6.07
Tender_157,2199730,2232802,1969909,943817,128850,7475108,41.0,5.9
Tender_158,1040675,598284,2371997,945447,355970,5312373,34.0,6.6
Tender_159,8092275,4052653,606848,266665,406621,13425062,36.0,6.4
Tender_160,6882361,3766281,1535143,77069,434885,12695739,23.33,7.67
Tender_161,1133660,4429199,78232,547909,228268,6417268,52.0,4.8
Tender_162,8213234,3040084,2347074,60705,396434,14057531,43.33,5.67
Tender_163,698382,3304437,860873,786446,296153,5946291,41.33,5.87
Tender_164,451884,2363036,2897619,287009,470381,6469929,51.33,4.87
Tender_165,9882995,2266585,1291927,95511,361331,13898349,46.67,5.33
Tender_166,6669859,1374894,187802,630932,290911,9154398,34.33,6.57
Tender_167,882526,2726265,248115,574887,337130,4768923,32.67,6.73
Tender_168,9413183,2950492,406177,891971,252226,13914049,41.67,5.83
Tender_169,9830770,4936689,2016962,767773,384031,17936225,40.33,5.97
Tender_170,7517548,2036315,246163,404478,109635,10314139,58.33,4.17
Tender_171,7999205,2170817,1348560,724315,119998,12362895,46.67,5.33
Tender_172,5334176,2225478,1930110,337194,342899,10169857,25.33,7.47
Tender_173,4627309,4566223,1732264,832360,448519,12206675,42.33,5.77
Tender_174,4022268,4326583,1253562,721558,262606,10586577,37.33,6.27
Tender_175,5617281,3296513,226267,244318,54077,9438456,47.33,5.27
Tender_176,3989586,4863034,100964,294388,79125,9327097,41.67,5.83
Tender_177,4859970,2777563,1094827,961554,162521,9856435,41.67,5.83
Tender_178,6306459,2686352,2779264,716571,183605,12672251,39.33,6.07
Tender_179,8467881,3510293,2401076,374954,122306,14876510,42.33,5.77
Tender_180,1391335,4684676,439321,848023,439172,7802527,43.33,5.67
Tender_181,7019810,606086,1625213,592930,137753,9981792,46.33,5.37
Tender_182,2095795,142049,253755,678762,392810,3563171,29.0,7.1
Tender_183,6284852,1152245,1626363,601910,137473,9802843,26.0,7.4
Tender_184,7342072,1585705,159678,275457,243387,9606299,53.33,4.67
Tender_185,3667627,224091,857033,845925,252359,5847035,37.33,6.27
Tender_186,4325259,3818359,643506,544217,118164,9449505,41.33,5.87
Tender_187,6731691,3639369,1768198,722675,482204,13344137,43.67,5.63
Tender_188,516891,2402267,433889,861520,194218,4408785,47.67,5.23
Tender_189,7041752,3372672,835387,482754,260790,11993355,31.0,6.9
Tender_190,1560672,3145790,1113276,847136,424240,7091114,43.33,5.67
Tender_191,490011,1789125,1143688,298069,430324,4151217,46.67,5.33
Tender_192,1520997,677624,866275,575875,309539,3950310,41.0,5.9
Tender_193,4269781,4274856,988555,666948,298525,10498665,36.33,6.37
Tender_194,2945284,3235816,1935720,394431,218973,8730224,48.33,5.17
Tender_195,3774422,2935634,1343006,713139,90944,8857145,45.67,5.43
Tender_196,1366663,4844125,2438834,488033,257460,9395115,41.33,5.87
Tender_197,3216865,3614149,1501757,102470,256054,8691295,32.0,6.8
Tender_198,3386598,1216316,1810398,590798,426262,7430372,39.67,6.03
Tender_199,561268,4072637,2173324,691368,496286,7994883,36.0,6.4
Tender_200,4025289,2316047,2210618,849699,263743,9665396,34.67,6.53
Tender_201,6895407,1170955,2439895,964438,169203,11639898,29.33,7.07
Tender_202,8538314,1913006,1860905,564507,50913,12927645,22.67,7.73
Tender_203,2876594,2043997,2172410,708547,177471,7979019,42.0,5.8
Tender_204,7368469,2621082,742462,800526,89982,11622521,34.0,6.6
Tender_205,8651408,1124615,2068433,247218,309806,12401480,27.0,7.3
Tender_206,4950139,1382135,998434,799473,396294,8526475,56.33,4.37
Tender_207,7601672,4677890,1116450,743476,128438,14267926,46.67,5.33
Tender_208,4038171,2117859,2074401,852192,110512,9193135,38.33,6.17
Tender_209,858914,2512090,230315,466577,478268,4546164,34.33,6.57
Tender_210,9301420,2098643,1909861,406952,102800,13819676,30.33,6.97
Tender_211,1648773,4047862,634273,356367,273039,6960314,33.0,6.7
Tender_212,7096668,296589,1231163,562304,135878,9322602,39.0,6.1
Tender_213,908708,2123014,1866423,512352,410504,5821001,39.0,6.1
Tender_214,3517299,3969444,815415,312746,209076,8823980,32.67,6.73
Tender_215,5948605,2957432,1440097,483601,434146,11263881,34.0,6.6
Tender_216,680645,1668151,2659055,833009,443097,6283957,47.33,5.27
Tender_217,3677229,3392097,2574159,112358,475273,10231116,33.67,6.63
Tender_218,4760533,3596482,2492761,135813,196164,11181753,35.0,6.5
Tender_219,2346387,4400531,2114309,747359,139216,9747802,31.0,6.9
Tender_220,936146,3240936,2502120,138343,85018,6902563,35.67,6.43
Tender_221,6916751,4106040,2220443,722490,267608,14233332,27.67,7.23
Tender_222,2646165,3088842,2420571,84421,435617,8675616,46.33,5.37
Tender_223,8716437,2013491,1840528,636656,403286,13610398,54.33,4.57
Tender_224,5961660,643885,2260844,330083,350123,9546595,48.67,5.13
Tender_225,9045810,3310883,1811889,968318,250655,15387555,34.0,6.6
Tender_226,348375,970039,600868,248076,85150,2252508,40.67,5.93
Tender_227,4806232,1683786,297908,705313,405128,7898367,43.33,5.67
Tender_228,2492364,2305259,1463067,962866,282207,7505763,33.67,6.63
Tender_229,5096493,3285936,2822525,791658,277268,12273880,51.0,4.9
Tender_230,9502602,4720740,1451276,661234,71070,16406922,48.0,5.2
Tender_231,5738054,2034921,180953,106030,51333,8111291,36.67,6.33
Tender_232,1872667,2072394,1636840,936399,53988,6572288,56.67,4.33
Tender_233,1487783,1169939,2078731,138727,380034,5255214,34.33,6.57
Tender_234,7427662,4162758,637289,493119,206788,12927616,46.67,5.33
Tender_235,9014782,3383003,2190415,853286,79867,15521353,34.0,6.6
Tender_236,9566722,3428094,601088,905737,417447,14919088,28.33,7.17
Tender_237,3937933,839699,1018120,706724,329670,6832146,40.33,5.97
Tender_238,2884325,3256660,1679942,719529,429753,8970209,40.33,5.97
Tender_239,1424052,1926363,83186,310211,466504,4210316,35.0,6.5
Tender_240,1293788,4310304,2241700,422091,148428,8416311,38.0,6.2
Tender_241,5441969,2457736,1040514,593358,454032,9987609,30.67,6.93
Tender_242,4333497,4491337,1464463,571556,347925,11208778,32.33,6.77
Tender_243,6532874,973118,769229,419663,150440,8845324,43.67,5.63
Tender_244,8514154,1110347,847640,159311,277044,10908496,33.67,6.63
Tender_245,9434396,3946501,935057,318511,405664,15040129,48.0,5.2
Tender_246,6007734,1372158,2538735,463843,257203,10639673,25.0,7.5
Tender_247,9059976,1347945,393465,71065,406235,11278686,27.0,7.3
Tender_248,7776424,2936480,2542779,107238,263258,13626179,36.67,6.33
Tender_249,4121009,1085151,2584690,196891,252110,8239851,27.67,7.23
Tender_250,3455908,1563448,2216723,380429,257554,7874062,26.67,7.33
Tender_251,4635616,2826108,1803438,262317,449989,9977468,24.33,7.57
Tender_252,6688035,4134196,630459,70224,119856,11642770,38.33,6.17
Tender_253,6550662,2657792,2782739,63197,255320,12309710,52.0,4.8
Tender_254,8294549,4447669,2916242,701750,66500,16426710,35.67,6.43
Tender_255,7388853,1091938,2063895,842090,316139,11702915,33.33,6.67
Tender_256,6897932,3030283,2062699,428869,372023,12791806,56.33,4.37
Tender_257,9108160,1851720,179153,932559,226936,12298528,45.0,5.5
Tender_258,2359325,1606520,628316,791969,413641,5799771,34.67,6.53
Tender_259,3685247,2680780,2381873,715927,222940,9686767,33.0,6.7
Tender_260,1113642,3731932,2126794,590509,338032,7900909,29.33,7.07
Tender_261,641766,534998,1118082,723890,315179,3333915,23.0,7.7
Tender_262,8391498,3262265,2350491,346982,493160,14844396,40.0,6.0
Tender_263,3702552,2003222,2505159,91586,418356,8720875,42.33,5.77
Tender_264,8116272,4409163,2979814,302900,154350,15962499,45.67,5.43
Tender_265,445287,1004129,778984,728388,378942,3335730,43.33,5.67
Tender_266,4227565,4498743,2310448,804608,298012,12139376,37.33,6.27
Tender_267,8673644,147185,831488,330093,112155,10094565,39.0,6.1
Tender_268,7799696,4516999,1067986,371111,74028,13829820,27.67,7.23
Tender_269,8489884,2875242,487856,699507,158645,12711134,41.33,5.87
Tender_270,5076051,3043823,850799,655438,223276,9849387,29.0,7.1
Tender_271,7456550,2379581,382343,809638,379731,11407843,42.0,5.8
Tender_272,4708928,1542190,2881298,121489,222282,9476187,37.0,6.3
Tender_273,4095799,394588,2499503,811160,343775,8144825,25.33,7.47
Tender_274,8715671,3384465,1974339,647703,192523,14914701,48.0,5.2
Tender_275,5932144,119306,2429684,432355,237607,9151096,21.33,7.87
Tender_276,482868,2195982,2613209,813849,159226,6265134,37.0,6.3
Tender_277,9004916,3412003,2974289,889658,311939,16592805,46.67,5.33
Tender_278,8894184,546284,447755,797076,310190,10995489,52.33,4.77
Tender_279,3003056,562453,627163,971683,380058,5544413,37.67,6.23
Tender_280,6441415,4173231,1058307,320039,348240,12341232,39.67,6.03
Tender_281,7765826,4694552,310568,53380,301768,13126094,46.0,5.4
Tender_282,713706,4904326,1873623,171200,173707,7836562,43.67,5.63
Tender_283,4939184,2264467,2692226,523148,199875,10618900,29.67,7.03
Tender_284,4656861,4937506,1518816,533338,112218,11758739,28.33,7.17
Tender_285,5854935,1900143,1507968,357303,294183,9914532,36.0,6.4
Tender_286,6044876,2940930,857132,693172,212318,10748428,26.33,7.37
Tender_287,4456691,155061,878569,425879,55244,5971444,45.0,5.5
Tender_288,2947684,3466102,1530349,70917,182284,8197336,37.33,6.27
Tender_289,9561780,922123,491331,250797,310342,11536373,37.0,6.3
Tender_290,4322746,4186235,1931390,381318,93688,10915377,31.33,6.87
Tender_291,6360975,3901189,1305752,336477,233885,12138278,38.0,6.2
Tender_292,8787835,1617256,2497835,316747,361844,13581517,50.33,4.97
Tender_293,9248659,1818726,1632745,690613,122478,13513221,15.33,8.47
Tender_294,8242675,4385625,2967891,776012,348230,16720433,29.67,7.03
Tender_295,4461457,1222682,1287608,181349,108967,7262063,44.0,5.6
Tender_296,3084874,365835,1684209,379202,123160,5637280,31.33,6.87
Tender_297,1835391,3924996,2323184,941679,414620,9439870,44.0,5.6
Tender_298,988354,3048064,1346926,284388,113020,5780752,34.67,6.53
Tender_299,9954402,707115,2688558,806603,179787,14336465,41.0,5.9
Tender_300,4671170,1049044,1852627,105526,485336,8163703,40.67,5.93
Tender_301,4115906,2110869,2109882,382224,478035,9196916,42.67,5.73
Tender_302,9325794,2616124,489047,874613,418544,13724122,46.0,5.4
Tender_303,951579,4793362,2579426,595136,231659,9151162,51.67,4.83
Tender_304,6044207,3710866,1245219,821779,471602,12293673,40.0,6.0
Tender_305,4922742,2947857,1959671,942058,313955,11086283,42.33,5.77
Tender_306,7837727,3881344,484819,952424,330472,13486786,45.33,5.47
Tender_307,4629016,3613217,1324451,789016,308380,10664080,27.0,7.3
Tender_308,8771601,4771654,1000875,148060,64360,14756550,45.33,5.47
Tender_309,8773957,1043128,2814590,249576,468340,13349591,31.33,6.87
Tender_310,4098871,200583,2822110,390770,182672,7695006,55.33,4.47
Tender_311,310656,2143547,2608613,436244,157971,5657031,35.67,6.43
Tender_312,2212543,1663510,1611237,165980,124244,5777514,37.67,6.23
Tender_313,8941545,608405,431423,238663,488187,10708223,49.33,5.07
Tender_314,7339948,1252321,2816196,963016,68941,12440422,35.33,6.47
Tender_315,1031016,1469168,1800182,739100,334065,5373531,40.67,5.93
Tender_316,9187490,2273279,536455,484260,59802,12541286,43.0,5.7
Tender_317,680782,125197,2772819,874762,421476,4875036,26.0,7.4
Tender_318,8064090,931018,2103267,744491,189115,12031981,41.33,5.87
Tender_319,6367525,4183511,757040,339173,478547,12125796,47.67,5.23
Tender_320,3892546,1965251,1167346,57383,464792,7547318,37.0,6.3
Tender_321,9821575,1443494,68613,76946,270601,11681229,37.0,6.3
Tender_322,4047632,4790651,1375357,637857,321310,11172807,23.67,7.63
Tender_323,9468742,795288,1074605,676128,429033,12443796,58.67,4.13
Tender_324,6251337,2777464,2470381,804480,347990,12651652,53.67,4.63
Tender_325,6505203,2802353,1106023,261960,372830,11048369,41.33,5.87
Tender_326,7773835,2686038,1967557,632856,82621,13142907,39.67,6.03
Tender_327,7308100,1853535,1938567,739140,77104,11916446,53.33,4.67
Tender_328,349984,641181,660624,517423,474599,2643811,34.67,6.53
Tender_329,683802,1296684,2722308,418096,353866,5474756,46.0,5.4
Tender_330,4429816,2280272,861493,387426,313031,8272038,41.0,5.9
Tender_331,3243007,3523486,314112,703754,329841,8114200,45.33,5.47
Tender_332,8237659,4197970,999570,881646,379074,14695919,52.0,4.8
Tender_333,868135,2199000,1001639,624064,483155,5175993,59.67,4.03
Tender_334,8836449,179195,895730,708760,276550,10896684,28.67,7.13
Tender_335,4221005,135762,1624843,865919,220743,7068272,34.33,6.57
Tender_336,7098726,2520998,464578,467561,276153,10828016,26.67,7.33
Tender_337,5829266,153987,1239428,618564,301120,8142365,51.33,4.87
Tender_338,5093682,2622650,956571,934020,450775,10057698,43.0,5.7
Tender_339,9017404,2147519,1265210,113754,467571,13011458,40.67,5.93
Tender_340,5229984,3862625,2745663,461704,153129,12453105,39.33,6.07
Tender_341,3506371,4703342,1382274,763656,152862,10508505,53.0,4.7
Tender_342,3827420,946925,1852051,475616,440954,7542966,36.33,6.37
Tender_343,8822063,2488146,1313344,495216,192251,13311020,39.33,6.07
Tender_344,339027,687747,2283258,857496,390776,4558304,32.0,6.8
Tender_345,6359872,1080793,1655896,339242,244483,9680286,47.67,5.23
Tender_346,3842293,4997585,2124528,256162,357500,11578068,45.67,5.43
Tender_347,7095326,3240718,371231,81598,312758,11101631,30.33,6.97
Tender_348,4080701,4535583,2763611,494061,406837,12280793,47.0,5.3
Tender_349,4424081,4018125,442472,521487,181569,9587734,47.0,5.3
Tender_350,7644337,1980772,1477645,253551,72358,11428663,32.33,6.77
Tender_351,1534376,3617942,836797,591562,440747,7021424,30.33,6.97
Tender_352,6697042,521841,2529330,558962,417130,10724305,42.67,5.73
Tender_353,8511563,3557833,1612965,378999,303014,14364374,47.33,5.27
Tender_354,8635538,2047253,2063839,92227,106441,12945298,36.0,6.4
Tender_355,883263,2317628,994254,205911,456440,4857496,25.0,7.5
Tender_356,4523164,435529,2990836,549737,417754,8917020,42.67,5.73
Tender_357,7650060,3213161,110053,933694,292607,12199575,27.67,7.23
Tender_358,9496169,767306,906958,991438,221902,12383773,32.33,6.77
Tender_359,1237197,1794215,925570,622707,417554,4997243,33.67,6.63
Tender_360,5983347,405542,1126846,510792,140037,8166564,34.33,6.57
Tender_361,5401472,487107,320871,722512,204936,7136898,37.67,6.23
Tender_362,4400552,3031205,1647224,922981,284086,10286048,35.67,6.43
Tender_363,6038913,3982607,97775,252252,427851,10799398,37.67,6.23
Tender_364,2400070,1661474,1322329,955083,273636,6612592,42.0,5.8
Tender_365,3077641,2054594,1671243,458236,363243,7624957,41.0,5.9
Tender_366,6418254,4842642,750848,221475,172312,12405531,43.0,5.7
Tender_367,8834713,3234338,2495209,850095,478333,15892688,46.33,5.37
Tender_368,3327015,1828487,262356,932417,339342,6689617,27.67,7.23
Tender_369,4596827,1669907,2694850,149724,368888,9480196,31.33,6.87
Tender_370,9936464,3893261,2070794,626491,222885,16749895,27.67,7.23
Tender_371,2004415,4841531,191109,360123,58532,7455710,21.33,7.87
Tender_372,5015124,1057058,2583510,584643,129149,9369484,41.0,5.9
Tender_373,9366660,4359281,1480021,124326,53784,15384072,41.0,5.9
Tender_374,311673,1529927,209695,520371,54150,2625816,26.33,7.37
Tender_375,9568930,2002243,370494,530453,477264,12949384,26.0,7.4
Tender_376,7718469,1949660,1215500,996041,480497,12360167,46.33,5.37
Tender_377,4543566,1134576,634955,948592,219491,7481180,23.33,7.67
Tender_378,5675273,3530412,2049957,319629,146999,11722270,46.33,5.37
Tender_379,9793428,4178874,1375776,398989,359671,16106738,40.67,5.93
Tender_380,3100818,1095812,1576573,383133,228482,6384818,35.0,6.5
Tender_381,1822611,3611449,2741711,921943,258686,9356400,25.67,7.43
Tender_382,8700934,1249310,763629,603221,469981,11787075,44.0,5.6
Tender_383,9814774,4964994,1746430,355005,195388,17076591,28.67,7.13
Tender_384,3596416,3582609,1033156,995996,132211,9340388,34.33,6.57
Tender_385,1840229,4718104,1587542,636745,255248,9037868,39.33,6.07
Tender_386,866604,649338,1144422,823015,391224,3874603,34.33,6.57
Tender_387,6014423,4024123,276953,968440,134029,11417968,34.33,6.57
Tender_388,8945275,2895619,1443815,878086,204874,14367669,49.33,5.07
Tender_389,8261567,2681540,2138629,666738,463227,14211701,38.33,6.17
Tender_390,6723754,4762000,171338,174624,403290,12235006,33.67,6.63
Tender_391,8933424,884040,394168,136146,227617,10575395,40.67,5.93
Tender_392,6907533,2509101,1091436,489737,336345,11334152,43.0,5.7
Tender_393,4511484,2572530,1773366,447293,277917,9582590,35.33,6.47
Tender_394,6574018,1184757,1092325,159901,111344,9122345,17.33,8.27
Tender_395,1299217,2165039,764781,557135,148495,4934667,49.0,5.1
Tender_396,9423826,1941975,1133413,302498,196144,12997856,49.67,5.03
Tender_397,4890852,2986293,2567853,731405,290591,11466994,44.67,5.53
Tender_398,1588581,1404979,999682,338811,249548,4581601,44.0,5.6
Tender_399,6645334,927217,2314350,785059,89057,10761017,45.67,5.43
Tender_400,5607321,2743730,2683798,837201,470566,12342616,31.67,6.83
Tender_401,8557201,3501700,2806669,566779,214751,15647100,42.67,5.73
Tender_402,1249206,510010,1194759,355635,204118,3513728,42.33,5.77
Tender_403,4563756,1280626,2992689,236833,53533,9127437,51.67,4.83
Tender_404,1940089,1921677,1434327,244578,50609,5591280,43.33,5.67
Tender_405,8571339,1509264,1989457,895253,106516,13071829,49.0,5.1
Tender_406,9455299,2624473,412977,127292,148129,12768170,39.33,6.07
Tender_407,7792909,4258873,1609375,658208,312574,14631939,52.67,4.73
Tender_408,5437849,2672160,2494557,681356,458548,11744470,46.67,5.33
Tender_409,2186014,3425411,1830394,123706,319047,7884572,39.67,6.03
Tender_410,701797,4520170,1775147,352570,51335,7401019,42.0,5.8
Tender_411,5684474,4126759,2942555,256248,98334,13108370,48.33,5.17
Tender_412,6930325,4862170,2433835,152866,202372,14581568,34.67,6.53
Tender_413,7101714,1212362,2573547,426069,175618,11489310,37.67,6.23
Tender_414,3455174,4242386,384101,966392,209224,9257277,37.0,6.3
Tender_415,2376029,818086,1273091,51117,113751,4632074,48.33,5.17
Tender_416,7104895,4720890,2511111,756799,330239,15423934,44.67,5.53
Tender_417,3190484,3037046,2353134,648436,406262,9635362,31.67,6.83
Tender_418,4840240,3072368,604080,511107,140887,9168682,39.33,6.07
Tender_419,7294462,698147,1482705,98301,198093,9771708,31.67,6.83
Tender_420,3859356,2028807,291307,554873,237725,6972068,49.33,5.07
Tender_421,734818,4018345,1146213,163083,148447,6210906,24.0,7.6
Tender_422,3223852,555088,1756068,717314,339815,6592137,39.0,6.1
Tender_423,5906240,1850160,383963,830621,321869,9292853,28.67,7.13
Tender_424,8469681,3048235,1730721,96996,50444,13396077,37.67,6.23
Tender_425,9307249,4975815,494693,211244,261663,15250664,24.33,7.57
Tender_426,7154879,3889804,2056670,719625,292619,14113597,56.33,4.37
Tender_427,5853954,3934828,372832,91401,484909,10737924,43.33,5.67
Tender_428,4104272,4647960,954384,851375,301446,10859437,51.33,4.87
Tender_429,5823999,235673,816845,213803,130123,7220443,28.0,7.2
Tender_430,8262324,4787802,2114062,724975,132841,16022004,23.0,7.7
Tender_431,9455036,4245985,524095,867581,206621,15299318,26.67,7.33
Tender_432,6634854,4346453,1213227,277556,155750,12627840,48.0,5.2
Tender_433,7231100,2531529,2111836,348359,172170,12394994,40.67,5.93
Tender_434,6761388,939888,502925,686730,351323,9242254,34.0,6.6
Tender_435,7921398,3941562,407306,237141,56425,12563832,29.33,7.07
Tender_436,3780955,4395115,2333447,431875,257591,11198983,31.0,6.9
Tender_437,7355856,3606411,1391785,92608,346723,12793383,38.67,6.13
Tender_438,671776,4053512,1682541,691473,215532,7314834,44.33,5.57
Tender_439,3872853,1977797,1059529,777091,434588,8121858,32.67,6.73
Tender_440,2636166,1908693,112748,472269,209821,5339697,52.33,4.77
Tender_441,1818290,3752151,1808764,136675,381764,7897644,36.33,6.37
Tender_442,2065806,1946933,2409724,625497,132992,7180952,28.67,7.13
Tender_443,2991618,4890383,259080,288924,136908,8566913,45.33,5.47
Tender_444,4851973,2624468,1760320,920478,167565,10324804,35.67,6.43
Tender_445,5594569,2862271,2878154,68710,99323,11503027,37.0,6.3
Tender_446,9624121,4224951,2968365,292001,60312,17169750,28.0,7.2
Tender_447,7405785,1653362,1873963,940857,471270,12345237,33.67,6.63
Tender_448,1576366,350192,2751246,584635,95071,5357510,36.0,6.4
Tender_449,6205304,1200554,403908,484475,141238,8435479,35.67,6.43
Tender_450,4809082,530830,866687,232225,442753,6881577,23.0,7.7
Tender_451,8294897,1827527,454156,625306,214574,11416460,30.67,6.93
Tender_452,9896797,2754462,808525,659790,83291,14202865,45.67,5.43
Tender_453,8709111,1471118,529844,637309,115743,11463125,57.0,4.3
Tender_454,5206518,1117835,589801,174665,338700,7427519,42.67,5.73
Tender_455,4654368,618430,2486655,942224,165157,8866834,47.67,5.23
Tender_456,1899398,2636101,2383393,939642,165388,8023922,41.0,5.9
Tender_457,9340471,4632971,2221489,638563,299143,17132637,41.33,5.87
Tender_458,6039862,907047,1970034,694296,475677,10086916,38.67,6.13
Tender_459,1312766,1094892,1117976,808296,59143,4393073,39.67,6.03
Tender_460,7096707,2275725,1802983,689481,418894,12283790,43.0,5.7
Tender_461,8801612,3601381,2722713,683666,280792,16090164,46.0,5.4
Tender_462,3613244,4536670,1639664,839814,372533,11001925,34.0,6.6
Tender_463,2862166,846876,2223993,292611,473475,6699121,42.0,5.8
Tender_464,8267436,2133384,1044008,217144,81072,11743044,57.0,4.3
Tender_465,7229189,4578569,1403405,620806,68003,13899972,24.67,7.53
Tender_466,2567695,2005404,478688,319164,159895,5530846,32.67,6.73
Tender_467,9145065,2145394,1642941,944650,82028,13960078,35.33,6.47
Tender_468,1177178,715838,383584,94789,132484,2503873,30.67,6.93
Tender_469,8773938,1875473,610662,910516,144083,12314672,43.33,5.67
Tender_470,2612542,4492243,847924,107621,195777,8256107,37.67,6.23
Tender_471,3882012,3711349,1236181,908009,380830,10118381,35.0,6.5
Tender_472,8336466,1768537,1842007,535529,136821,12619360,24.33,7.57
Tender_473,2038810,2524191,536014,587314,292210,5978539,38.67,6.13
Tender_474,663623,4921879,377248,935418,346770,7244938,54.67,4.53
Tender_475,6469881,1238011,2461954,195482,421112,10786440,52.0,4.8
Tender_476,7226032,1905144,621642,484628,161831,10399277,28.67,7.13
Tender_477,388919,2813990,1697395,947572,100720,5948596,28.67,7.13
Tender_478,2958261,1226985,907774,747181,256915,6097116,56.67,4.33
Tender_479,3510664,2438575,912810,718551,256694,7837294,38.33,6.17
Tender_480,3989433,1751168,2541365,685977,173789,9141732,31.33,6.87
Tender_481,8749537,4190690,855510,268117,430635,14494489,39.33,6.07
Tender_482,540880,1037192,208822,128277,411979,2327150,29.33,7.07
Tender_483,4837788,472456,2487963,762546,464604,9025357,37.33,6.27
Tender_484,7677665,2438673,212437,277244,124264,10730283,40.67,5.93
Tender_485,4318789,934305,1865496,228692,195745,7543027,39.33,6.07
Tender_486,2755815,3999248,2793413,884290,94564,10527330,32.33,6.77
Tender_487,8433181,3438167,1507009,936840,313356,14628553,33.67,6.63
Tender_488,3278094,1663994,2233002,320847,60038,7555975,45.33,5.47
Tender_489,2362518,4763007,2762190,872426,319511,11079652,45.0,5.5
Tender_490,4774538,2889103,643428,159688,96549,8563306,50.0,5.0
Tender_491,3389600,982480,686758,668097,452616,6179551,53.67,4.63
Tender_492,8411345,153804,2404791,882310,194142,12046392,32.33,6.77
Tender_493,5495463,2197017,1012160,152251,303133,9160024,32.0,6.8
Tender_494,9265788,156781,68177,112323,457133,10060202,39.67,6.03
Tender_495,1842065,692823,76939,718993,494946,3825766,43.67,5.63
Tender_496,1921670,3554203,2468250,104256,404165,8452544,31.33,6.87
Tender_497,7347323,2401665,1180462,763884,441652,12134986,29.33,7.07
Tender_498,2447746,451231,1669181,972234,343873,5884265,45.0,5.5
Tender_499,5970245,2342382,983701,235905,494655,10026888,35.33,6.47
Tender_500,9819091,313224,1319755,184420,470302,12106792,44.33,5.57
Tender_501,6752360,2010999,2276603,945642,430496,12416100,44.67,5.53
Tender_502,7686449,4027183,392381,411855,212266,12730134,44.67,5.53
Tender_503,1284534,3457308,2371343,666180,435561,8214926,34.67,6.53
Tender_504,8647851,1185442,1798252,775203,83541,12490289,25.67,7.43
Tender_505,6379300,1067849,2494688,151984,236765,10330586,29.0,7.1
Tender_506,1382936,1027386,1555289,486447,122247,4574305,32.0,6.8
Tender_507,2196678,4531638,1381776,285473,173095,8568660,36.67,6.33
Tender_508,4703113,4762418,2489935,271498,237734,12464698,43.33,5.67
Tender_509,7611275,270151,2771151,940428,315666,11908671,50.33,4.97
Tender_510,7608115,3763617,2832071,783310,337472,15324585,32.33,6.77
Tender_511,8013301,410277,1819611,322689,131035,10696913,31.67,6.83
Tender_512,2199898,2420014,416029,402519,429966,5868426,52.67,4.73
Tender_513,6639684,2152045,1882449,271247,312884,11258309,32.33,6.77
Tender_514,3598391,4326003,2894680,834401,52619,11706094,36.33,6.37
Tender_515,2151211,770391,2364644,363017,425172,6074435,33.0,6.7
Tender_516,5499812,1004362,2923427,242000,415973,10085574,50.0,5.0
Tender_517,3527978,2650488,2526973,721678,487166,9914283,45.67,5.43
Tender_518,8984734,4399715,2704870,165611,489490,16744420,49.67,5.03
Tender_519,1046463,1333849,388820,69916,471611,3310659,39.67,6.03
Tender_520,6936978,686623,1166205,442112,153780,9385698,40.0,6.0
Tender_521,2587861,4935766,2441560,437121,88480,10490788,41.0,5.9
Tender_522,7995152,1041043,227046,617978,118045,9999264,44.0,5.6
Tender_523,8780608,1522773,2957331,780685,437414,14478811,54.33,4.57
Tender_524,6817430,100666,2353176,977515,185149,10433936,36.33,6.37
Tender_525,2067149,3252097,2372453,679730,158262,8529691,38.0,6.2
Tender_526,1767420,1330131,2558391,959509,327453,6942904,48.67,5.13
Tender_527,8898451,2228765,2663852,163809,297187,14252064,32.0,6.8
Tender_528,9825806,2510369,580575,124258,462521,13503529,21.33,7.87
Tender_529,1298753,634555,314297,691015,78791,3017411,51.0,4.9
Tender_530,9695948,4530338,768817,607963,91752,15694818,40.67,5.93
Tender_531,2963853,2748631,163873,295188,283876,6455421,27.0,7.3
Tender_532,9570909,275134,894588,178291,258093,11177015,34.33,6.57
Tender_533,4067328,680232,2681872,95637,368065,7893134,24.67,7.53
Tender_534,4905960,3595388,102614,994194,157759,9755915,35.33,6.47
Tender_535,4704567,3619770,2375953,968264,107505,11776059,44.67,5.53
Tender_536,815116,2546483,781636,288491,199516,4631242,35.33,6.47
Tender_537,2391159,763231,2924207,106471,66381,6251449,42.0,5.8
Tender_538,7476269,2951647,1977561,834120,128215,13367812,38.67,6.13
Tender_539,962472,253559,963390,768423,293696,3241540,59.0,4.1
Tender_540,8804097,3186463,1852064,424187,331185,14597996,33.0,6.7
Tender_541,3969831,4248005,889753,206317,181421,9495327,29.0,7.1
Tender_542,5784798,2869229,2801789,869128,369306,12694250,59.33,4.07
Tender_543,9515320,3336650,1651327,524387,464608,15492292,34.67,6.53
Tender_544,9296296,4519760,1468669,71467,427791,15783983,30.67,6.93
Tender_545,9705486,827119,1783821,262234,494998,13073658,48.67,5.13
Tender_546,7994006,720612,2027042,314694,92472,11148826,45.33,5.47
Tender_547,4932720,2018133,2719122,318098,367957,10356030,44.0,5.6
Tender_548,3762160,2219785,1618581,815892,126874,8543292,32.67,6.73
Tender_549,6486474,1963291,1739512,123319,360594,10673190,35.67,6.43
Tender_550,5323554,745352,2514362,610857,149622,9343747,45.33,5.47
Tender_551,1219608,2937162,1656455,718935,161770,6693930,24.67,7.53
Tender_552,8740811,1969950,1530317,337032,303163,12881273,38.33,6.17
Tender_553,5485576,1642766,1129235,371110,138434,8767121,45.33,5.47
Tender_554,9403838,1964007,804833,855873,455649,13484200,41.0,5.9
Tender_555,5068417,886796,182364,109394,463672,6710643,56.67,4.33
Tender_556,2870110,2274257,2534642,792419,355339,8826767,40.0,6.0
Tender_557,223891,2048969,1421950,365087,284082,4343979,44.67,5.53
Tender_558,5225522,1225632,2373943,270490,207512,9303099,28.0,7.2
Tender_559,6280042,4439481,694640,585061,236349,12235573,41.0,5.9
Tender_560,4411773,1397905,733217,787942,405471,7736308,26.0,7.4
Tender_561,3206271,1411019,1936508,57657,361992,6973447,29.67,7.03
Tender_562,8650813,1843378,2785695,570816,170164,14020866,37.67,6.23
Tender_563,8510797,3178874,1382557,990226,233232,14295686,26.67,7.33
Tender_564,6720197,3467703,81456,978046,231484,11478886,55.0,4.5
Tender_565,8045552,2131747,2751015,422021,58703,13409038,48.0,5.2
Tender_566,5887946,2426378,1320939,426520,420207,10481990,38.67,6.13
Tender_567,7472576,4112219,1255164,993856,489268,14323083,50.67,4.93
Tender_568,7770524,1502377,1818491,336476,391276,11819144,58.67,4.13
Tender_569,5498786,3700240,1396964,825416,465223,11886629,33.33,6.67
Tender_570,4016923,1495205,1647643,865939,275347,8301057,37.0,6.3
Tender_571,8936415,2365941,1937123,87659,127236,13454374,43.33,5.67
Tender_572,7067409,3830008,190989,398721,444304,11931431,26.0,7.4
Tender_573,7061835,973718,518825,849882,477997,9882257,48.33,5.17
Tender_574,9604402,2058239,2976563,710593,360063,15709860,32.0,6.8
Tender_575,8873493,4896245,1801804,867037,205969,16644548,52.67,4.73
Tender_576,1478274,893063,655393,844937,119621,3991288,26.67,7.33
Tender_577,5432456,3628332,2862528,721019,487797,13132132,29.33,7.07
Tender_578,5946547,2766253,2584704,429551,438442,12165497,32.0,6.8
Tender_579,3765762,1495781,2670789,751378,68569,8752279,28.67,7.13
Tender_580,2382864,3823131,2361629,708115,190253,9465992,57.0,4.3
Tender_581,5345293,3809246,2161101,383702,378738,12078080,36.67,6.33
Tender_582,1661831,1770981,1546480,633782,469607,6082681,26.67,7.33
Tender_583,3553788,145835,2335464,443566,307231,6785884,28.67,7.13
Tender_584,3602156,4664805,1326467,924070,266034,10783532,23.67,7.63
Tender_585,8394418,4087857,2633207,369170,158632,15643284,40.67,5.93
Tender_586,3617833,1234287,2848587,328197,172613,8201517,19.33,8.07
Tender_587,3355778,2213619,352205,381712,54178,6357492,39.67,6.03
Tender_588,3105800,185120,1750458,200795,476159,5718332,45.33,5.47
Tender_589,6831334,2060896,1549844,470184,96771,11009029,53.0,4.7
Tender_590,5284105,3421901,2245177,349205,462893,11763281,26.33,7.37
Tender_591,1071235,2506033,1298737,460534,88818,5425357,39.0,6.1
Tender_592,8931704,4504225,2530721,432854,138522,16538026,53.33,4.67
Tender_593,1821849,438692,314162,75459,62842,2713004,36.33,6.37
Tender_594,5220069,204009,1227053,547974,216118,7415223,34.67,6.53
Tender_595,5403289,1485349,1267019,222581,114601,8492839,33.33,6.67
Tender_596,5007508,3078318,524901,844348,196158,9651233,37.67,6.23
Tender_597,9629366,2509866,1648282,790523,188878,14766915,40.33,5.97
Tender_598,9772391,177224,2257800,266894,419788,12894097,34.67,6.53
Tender_599,1209047,3719657,1640913,145518,401850,7116985,30.0,7.0
Tender_600,2646751,2357908,126205,901547,385193,6417604,34.0,6.6
Tender_601,600919,3302453,1503365,751087,416563,6574387,34.0,6.6
Tender_602,8939508,3902902,810602,311789,352951,14317752,29.67,7.03
Tender_603,5176851,3643973,1537844,968016,322471,11649155,23.0,7.7
Tender_604,2556763,3168729,1899936,335828,195939,8157195,30.0,7.0
Tender_605,8044494,641864,973915,163090,118974,9942337,27.67,7.23
Tender_606,4119759,4227062,2746772,692135,293733,12079461,30.67,6.93
Tender_607,6181675,1324545,2875631,153012,309367,10844230,32.67,6.73
Tender_608,9956920,4161188,1201979,737132,338330,16395549,32.33,6.77
Tender_609,2031217,4287979,2587400,506310,344790,9757696,24.0,7.6
Tender_610,9791793,2729037,2420321,209554,246084,15396789,29.33,7.07
Tender_611,2344013,1942161,2189906,639494,282595,7398169,41.0,5.9
Tender_612,1761478,1417366,1468844,589776,87490,5324954,34.0,6.6
Tender_613,5496029,4949548,99577,362407,65598,10973159,54.33,4.57
Tender_614,8194505,1047438,954006,337384,111710,10645043,42.67,5.73
Tender_615,8703405,1205446,221490,614178,116839,10861358,48.67,5.13
Tender_616,7380682,1804360,2226346,280762,286426,11978576,30.67,6.93
Tender_617,4515095,3316505,918036,439302,448993,9637931,53.0,4.7
Tender_618,4831706,2821970,2163698,952261,163156,10932791,32.0,6.8
Tender_619,9104979,2885492,2665103,562634,349481,15567689,27.33,7.27
Tender_620,2937590,3752465,642939,842458,301837,8477289,27.67,7.23
Tender_621,9655658,2555219,1141773,402268,329904,14084822,38.0,6.2
Tender_622,7468178,2268508,1179888,280712,458692,11655978,52.67,4.73
Tender_623,1530275,1010062,2485792,780584,265996,6072709,60.67,3.93
Tender_624,3014007,2284599,297829,119065,187804,5903304,31.33,6.87
Tender_625,411425,1745536,84984,363816,222656,2828417,23.67,7.63
Tender_626,5453457,137008,2561894,630277,488402,9271038,36.67,6.33
Tender_627,2686377,361726,324601,854919,113435,4341058,28.33,7.17
Tender_628,8765222,706950,1383350,921488,259771,12036781,43.67,5.63
Tender_629,7705394,3187836,1124315,895883,304505,13217933,32.67,6.73
Tender_630,659100,109697,705383,54701,338699,1867580,50.33,4.97
Tender_631,797105,1934941,734291,600930,323254,4390521,15.67,8.43
Tender_632,2216701,4799880,392969,152846,242653,7805049,43.0,5.7
Tender_633,9844799,1630162,2394733,103126,440570,14413390,36.33,6.37
Tender_634,999682,2230503,1315789,217818,59899,4823691,34.33,6.57
Tender_635,6519483,204605,878203,877620,243781,8723692,34.0,6.6
Tender_636,2847964,2096713,2955865,470789,474420,8845751,41.33,5.87
Tender_637,4997780,495887,719971,185780,402575,6801993,28.67,7.13
Tender_638,7358788,1477151,934243,295138,110427,10175747,33.33,6.67
Tender_639,6451481,1258756,2874980,721461,324411,11631089,52.0,4.8
Tender_640,2753325,4354842,67952,291352,50088,7517559,30.67,6.93
Tender_641,1302041,1978267,2026387,268013,471771,6046479,37.33,6.27
Tender_642,2314783,2695033,1204314,198649,371593,6784372,44.33,5.57
Tender_643,2739667,1789138,2155226,698448,281934,7664413,46.67,5.33
Tender_644,6118170,3339518,1992538,933769,75317,12459312,35.33,6.47
Tender_645,7003090,2380296,1258055,478161,95005,11214607,42.0,5.8
Tender_646,2776628,2621200,1523667,136790,164700,7222985,45.33,5.47
Tender_647,4434993,3199623,837239,672113,383491,9527459,46.33,5.37
Tender_648,5072584,3318684,1170138,826740,91793,10479939,34.67,6.53
Tender_649,3872490,3662144,2830672,305338,244857,10915501,47.67,5.23
Tender_650,7936146,1780927,2722368,71358,65161,12575960,55.33,4.47
Tender_651,7159946,295897,79410,59395,399733,7994381,33.33,6.67
Tender_652,2771944,473034,566845,188226,333735,4333784,37.33,6.27
Tender_653,2821296,3278139,281651,94682,468392,6944160,39.67,6.03
Tender_654,838478,3676868,2854613,517278,456867,8344104,48.67,5.13
Tender_655,7310893,4888774,1999812,692812,440178,15332469,39.33,6.07
Tender_656,7223866,2724325,2773484,59181,460368,13241224,39.33,6.07
Tender_657,6077507,4708607,1266240,456737,68188,12577279,28.0,7.2
Tender_658,4568717,545197,2437967,939042,272979,8763902,40.67,5.93
Tender_659,6358634,2506750,2690304,357657,134954,12048299,32.67,6.73
Tender_660,7155088,2371265,248638,517301,439581,10731873,54.67,4.53
Tender_661,7255575,258556,666772,267275,471352,8919530,40.33,5.97
Tender_662,8511162,3382815,2747835,940594,285699,15868105,51.0,4.9
Tender_663,1103869,3510670,1612599,683510,139325,7049973,24.0,7.6
Tender_664,3381688,2628280,2117625,819960,350821,9298374,23.0,7.7
Tender_665,7588391,2711347,847697,383979,298508,11829922,47.33,5.27
Tender_666,1005027,3522812,2967543,798075,207520,8500977,32.67,6.73
Tender_667,7579392,3193763,2817385,604590,88238,14283368,47.67,5.23
Tender_668,988531,658776,1622784,87491,134100,3491682,57.0,4.3
Tender_669,1325951,2880201,2488905,74515,302398,7071970,29.67,7.03
Tender_670,1056937,3984571,1968577,823307,453627,8287019,36.33,6.37
Tender_671,9695489,888700,2679660,620623,414903,14299375,29.67,7.03
Tender_672,6486706,4171706,733974,832338,325122,12549846,38.67,6.13
Tender_673,6324818,4945500,2318512,973535,129561,14691926,41.67,5.83
Tender_674,8313115,1376796,298561,766146,147441,10902059,49.67,5.03
Tender_675,6127330,2044851,1317299,153616,138162,9781258,48.67,5.13
Tender_676,4119857,522047,1703929,826901,151162,7323896,37.33,6.27
Tender_677,8716763,206083,1766391,992357,200341,11881935,29.67,7.03
Tender_678,9066775,1250157,1910572,547860,145036,12920400,42.67,5.73
Tender_679,2366561,4510228,1286575,327117,170354,8660835,46.0,5.4
Tender_680,5949017,4322765,1795562,369981,137015,12574340,21.33,7.87
Tender_681,7801909,1800031,1286992,124176,124876,11137984,27.0,7.3
Tender_682,9521953,2430419,2589118,818163,414027,15773680,41.67,5.83
Tender_683,4476622,4949612,1096933,144951,157673,10825791,41.0,5.9
Tender_684,3653912,1162285,613604,538997,68516,6037314,48.0,5.2
Tender_685,7899613,4599246,1546072,93589,357158,14495678,30.33,6.97
Tender_686,1760433,2338322,506602,854599,383616,5843572,53.33,4.67
Tender_687,1925109,2589028,1629281,539349,291495,6974262,51.67,4.83
Tender_688,8178796,2882372,1354549,214415,381642,13011774,15.67,8.43
Tender_689,1403803,2851060,2536399,804934,79383,7675579,44.67,5.53
Tender_690,9533436,446417,2622184,302852,416817,13321706,43.0,5.7
Tender_691,6079519,4087195,2194356,984540,97813,13443423,37.67,6.23
Tender_692,6969150,2701270,2076936,74744,421208,12243308,40.67,5.93
Tender_693,1993465,1538152,1127562,802565,145573,5607317,22.0,7.8
Tender_694,1249981,4420704,821572,618282,252449,7362988,27.0,7.3
Tender_695,8126134,1287866,2121169,897908,337877,12770954,31.33,6.87
Tender_696,9368518,4670463,2771155,675211,444285,17929632,30.33,6.97
Tender_697,1556931,269913,167238,359343,471303,2824728,37.0,6.3
Tender_698,8609267,1746144,360171,472497,120270,11308349,38.33,6.17
Tender_699,9599310,4192556,2986288,475303,450665,17704122,25.33,7.47
Tender_700,8382224,4969701,2198527,508111,103263,16161826,43.33,5.67
Tender_701,5720088,2396983,2635557,213953,173225,11139806,43.67,5.63
Tender_702,8670620,2348125,1999776,700245,155248,13874014,60.0,4.0
Tender_703,1683405,352690,707852,588313,190300,3522560,38.0,6.2
Tender_704,6230106,539261,988651,126232,117186,8001436,38.67,6.13
Tender_705,9425049,185134,2595801,665848,483803,13355635,27.33,7.27
Tender_706,2206090,643655,2148158,923580,151313,6072796,44.67,5.53
Tender_707,9066475,130802,2920923,672797,287017,13078014,31.0,6.9
Tender_708,7403074,2859629,1441400,533601,182391,12420095,29.0,7.1
Tender_709,2532132,3735605,2219046,586240,420807,9493830,45.0,5.5
Tender_710,4156892,4549752,1962493,594105,167323,11430565,29.33,7.07
Tender_711,3645790,4940721,2411100,248188,457068,11702867,42.0,5.8
Tender_712,8026533,4157191,2212561,412667,471720,15280672,42.67,5.73
Tender_713,8896425,4076861,256780,584741,267686,14082493,38.67,6.13
Tender_714,4684929,522752,1732918,721176,427224,8088999,48.33,5.17
Tender_715,1156812,1980818,1872862,856527,479345,6346364,24.67,7.53
Tender_716,8646601,3725896,1766567,337776,127751,14604591,30.0,7.0
Tender_717,7966593,2259486,1548135,250892,483391,12508497,41.67,5.83
Tender_718,1335282,3259364,1389187,338884,446403,6769120,42.0,5.8
Tender_719,9848055,2648870,667020,714578,121241,13999764,37.0,6.3
Tender_720,6307778,2628923,1163768,147433,152664,10400566,44.67,5.53
Tender_721,8199724,1226964,2215444,542342,357361,12541835,49.67,5.03
Tender_722,1525985,1382426,2408335,504091,325403,6146240,24.67,7.53
Tender_723,5982930,1064685,1562031,848557,147876,9606079,44.0,5.6
Tender_724,6949348,3478840,986727,410085,303377,12128377,42.67,5.73
Tender_725,3166646,4985117,184324,115202,79442,8530731,33.67,6.63
Tender_726,1980896,3511178,1082198,307364,59431,6941067,27.33,7.27
Tender_727,360536,4490844,1238436,500876,252285,6842977,42.67,5.73
Tender_728,1019627,1524831,1843160,66436,273015,4727069,46.67,5.33
Tender_729,512301,4294628,2361587,224066,125253,7517835,29.0,7.1
Tender_730,4534541,3727730,1843688,679101,372333,11157393,36.0,6.4
Tender_731,8373495,4829165,2937832,134133,194499,16469124,30.33,6.97
Tender_732,1373978,4182176,1935040,682797,148590,8322581,33.0,6.7
Tender_733,9784444,4994461,916691,275904,456220,16427720,39.0,6.1
Tender_734,5088819,3906892,153234,72342,349982,9571269,37.33,6.27
Tender_735,947577,4971564,1112081,415346,302666,7749234,32.67,6.73
Tender_736,7484877,2062545,272362,757125,382058,10958967,36.67,6.33
Tender_737,5711594,2561268,2815074,176901,138353,11403190,28.67,7.13
Tender_738,7469809,4294453,81822,212058,189177,12247319,49.33,5.07
Tender_739,8855515,2782205,268018,538242,121198,12565178,30.0,7.0
Tender_740,5890937,3727824,2667857,117761,145872,12550251,28.67,7.13
Tender_741,845088,1674714,1606439,680881,279902,5087024,34.67,6.53
Tender_742,1123997,3127029,936430,605695,349416,6142567,30.0,7.0
Tender_743,3449575,4073682,1623551,131558,149227,9427593,29.0,7.1
Tender_744,7652467,1150613,1509590,112772,204832,10630274,35.33,6.47
Tender_745,269357,1178468,2760569,663797,432036,5304227,32.67,6.73
Tender_746,9292085,1774279,1880362,859636,273209,14079571,40.33,5.97
Tender_747,7195438,812550,2021277,590162,132481,10751908,22.33,7.77
Tender_748,1261204,2749644,886046,847942,395587,6140423,48.67,5.13
Tender_749,5276607,1162535,2140673,874183,376500,9830498,31.0,6.9
Tender_750,7297114,3477857,835726,998763,70598,12680058,52.67,4.73
Tender_751,3643613,379611,2584174,325167,298854,7231419,42.0,5.8
Tender_752,1580602,3121245,815553,873726,230176,6621302,48.0,5.2
Tender_753,1107221,3939321,1783288,327439,469979,7627248,40.33,5.97
Tender_754,2577827,2496899,2166038,885853,130300,8256917,46.0,5.4
Tender_755,7915606,4688058,2114024,476965,137938,15332591,38.67,6.13
Tender_756,5122724,676655,1665609,382683,280882,8128553,33.67,6.63
Tender_757,3108167,2725562,351002,885133,301639,7371503,31.0,6.9
Tender_758,3844588,3935532,624262,191657,229417,8825456,40.67,5.93
Tender_759,8099713,2775780,2209999,368754,327471,13781717,15.33,8.47
Tender_760,8694246,4546533,2321416,714009,316637,16592841,32.0,6.8
Tender_761,3456390,1102779,1179916,918571,498684,7156340,39.67,6.03
Tender_762,7684757,298690,1189524,604103,328037,10105111,24.0,7.6
Tender_763,7306025,399013,509015,636757,286617,9137427,34.33,6.57
Tender_764,2513072,748738,1356531,188451,113687,4920479,36.0,6.4
Tender_765,4176239,3194916,582824,497179,198331,8649489,44.33,5.57
Tender_766,2056613,2673304,1593027,421462,172430,6916836,39.0,6.1
Tender_767,4814756,2687117,1017720,191077,410604,9121274,56.0,4.4
Tender_768,8113938,3954173,2775193,260228,258565,15362097,43.0,5.7
Tender_769,269254,3118014,1019926,343561,226705,4977460,41.0,5.9
Tender_770,1757299,632612,1811395,274009,180862,4656177,46.67,5.33
Tender_771,2643240,1606620,127358,110823,403693,4891734,58.33,4.17
Tender_772,6806382,2290428,761448,371388,353873,10583519,39.67,6.03
Tender_773,502051,3214054,2364741,94912,154011,6329769,29.33,7.07
Tender_774,6410953,4212397,1866709,453690,187538,13131287,28.67,7.13
Tender_775,7026585,2072006,2576842,967376,292762,12935571,42.67,5.73
Tender_776,2832336,4099232,147176,279936,365566,7724246,42.67,5.73
Tender_777,2361123,4882168,2382094,183530,296169,10105084,51.0,4.9
Tender_778,6960303,4638196,2196125,414610,77991,14287225,44.67,5.53
Tender_779,6704595,2350038,2138329,819313,155310,12167585,30.0,7.0
Tender_780,2924123,4386685,2063145,758337,115578,10247868,18.67,8.13
Tender_781,4122805,418170,1376299,201838,323503,6442615,41.33,5.87
Tender_782,6704917,578327,2125836,641141,332787,10383008,42.33,5.77
Tender_783,2448581,1330462,2279538,438614,204501,6701696,36.33,6.37
Tender_784,1075799,134571,2097011,453234,434019,4194634,38.67,6.13
Tender_785,1775660,1968497,884885,671318,75555,5375915,49.0,5.1
Tender_786,4094068,1509966,1616735,140067,190722,7551558,50.67,4.93
Tender_787,5050364,4449507,2540102,64974,450166,12555113,31.67,6.83
Tender_788,2573434,4245454,1184449,255387,201754,8460478,31.0,6.9
Tender_789,1906700,532216,1271098,436676,275286,4421976,53.0,4.7
Tender_790,4419014,3806262,1774355,217540,238683,10455854,55.67,4.43
Tender_791,8746989,4482446,1064742,349480,276952,14920609,37.33,6.27
Tender_792,8576925,4948513,1184059,807686,228974,15746157,40.0,6.0
Tender_793,7533995,3324555,780761,749025,348514,12736850,55.67,4.43
Tender_794,4045372,669263,2153396,933438,416796,8218265,27.67,7.23
Tender_795,722326,4115141,2853164,157582,213643,8061856,38.67,6.13
Tender_796,2670148,4517773,1602442,435472,333721,9559556,38.33,6.17
Tender_797,8597400,2067928,1016144,347134,383272,12411878,51.67,4.83
Tender_798,6810017,1357585,1522415,358684,176763,10225464,31.33,6.87
Tender_799,2397894,1216539,2026798,525636,254347,6421214,36.0,6.4
Tender_800,8626535,3229548,1344988,700906,439182,14341159,44.33,5.57
Tender_801,2038284,586785,1836303,798823,300925,5561120,34.67,6.53
Tender_802,1560022,974351,704867,789042,356754,4385036,53.67,4.63
Tender_803,9443917,3189417,251584,652580,118716,13656214,33.33,6.67
Tender_804,499209,3126347,1836200,399943,82551,5944250,49.0,5.1
Tender_805,3591216,3894647,1760602,906539,335504,10488508,44.67,5.53
Tender_806,2207851,2024431,1480934,595826,376642,6685684,38.33,6.17
Tender_807,6753608,1431875,696075,124386,428954,9434898,40.33,5.97
Tender_808,8936180,1590968,2105886,781852,204334,13619220,26.33,7.37
Tender_809,9314183,1320398,1000110,619149,238240,12492080,37.33,6.27
Tender_810,5733150,1645569,1433556,383773,261139,9457187,48.0,5.2
Tender_811,3422786,2134119,2555368,778913,105965,8997151,52.0,4.8
Tender_812,6318932,1231836,2773565,991558,411964,11727855,18.33,8.17
Tender_813,1357721,3470690,1644549,56460,129729,6659149,44.67,5.53
Tender_814,3418852,410105,1406679,170372,420578,5826586,21.33,7.87
Tender_815,6057726,855827,1543866,221567,113338,8792324,39.67,6.03
Tender_816,8665301,3903906,698544,70608,61312,13399671,48.33,5.17
Tender_817,3332048,3110732,2273046,600278,298752,9614856,27.33,7.27
Tender_818,7385172,2500407,2420095,266052,225317,12797043,25.67,7.43
Tender_819,4388040,1307244,2187153,589598,301245,8773280,40.67,5.93
Tender_820,8552884,3399410,244066,654605,473460,13324425,42.33,5.77
Tender_821,4928844,4553091,267201,229429,349486,10328051,42.67,5.73
Tender_822,7693032,4467190,384750,152727,83598,12781297,32.67,6.73
Tender_823,9007570,1828539,2142126,121610,381444,13481289,37.33,6.27
Tender_824,8978955,1501660,1731118,480392,341550,13033675,43.33,5.67
Tender_825,9082945,606340,2490390,997789,333311,13510775,40.67,5.93
Tender_826,2574056,4919354,1687368,254708,131178,9566664,43.33,5.67
Tender_827,5183086,771224,1700907,330503,272334,8258054,45.33,5.47
Tender_828,5757856,1241233,1847727,568707,273286,9688809,36.33,6.37
Tender_829,2289862,2386442,2690026,66265,407364,7839959,46.67,5.33
Tender_830,8936208,1350724,2145363,972674,113216,13518185,47.0,5.3
Tender_831,8561142,1847137,572541,173915,299007,11453742,42.33,5.77
Tender_832,9155355,2707771,1395383,937722,82561,14278792,41.0,5.9
Tender_833,2092608,4733331,1767394,468137,96603,9158073,54.33,4.57
Tender_834,3833348,1680237,2867146,860769,383873,9625373,42.67,5.73
Tender_835,3779458,415522,2693374,884516,167446,7940316,40.0,6.0
Tender_836,9730500,3607945,886400,903411,459344,15587600,49.0,5.1
Tender_837,2220727,759539,127926,432341,270280,3810813,32.33,6.77
Tender_838,8447315,4435860,2708466,313397,173037,16078075,43.33,5.67
Tender_839,2692785,2370773,1889286,176199,475253,7604296,53.0,4.7
Tender_840,3516645,2883456,1581670,599430,232153,8813354,31.0,6.9
Tender_841,2383164,3501662,2454798,299981,167463,8807068,36.0,6.4
Tender_842,9488421,4158390,629246,755073,65755,15096885,43.33,5.67
Tender_843,8903947,1305196,1482569,716097,50953,12458762,41.67,5.83
Tender_844,2846630,3777882,1936901,760890,185220,9507523,30.33,6.97
Tender_845,3975770,4386689,2670050,589825,387064,12009398,55.0,4.5
Tender_846,3271728,3037765,1974318,335731,276470,8896012,30.0,7.0
Tender_847,7874394,4122957,2013588,188701,236639,14436279,53.0,4.7
Tender_848,5562640,1751658,2768339,692458,409873,11184968,28.33,7.17
Tender_849,5336986,294166,1656394,766203,132173,8185922,45.0,5.5
Tender_850,1754833,1222389,1646730,761538,132936,5518426,33.0,6.7
Tender_851,3612989,1861657,2401963,271901,455334,8603844,19.0,8.1
Tender_852,9089493,2540585,254797,707535,368334,12960744,51.0,4.9
Tender_853,8123432,4777402,191918,488381,283507,13864640,42.0,5.8
Tender_854,1031294,2543285,130685,895899,321313,4922476,50.33,4.97
Tender_855,6448712,4127117,763694,273380,140322,11753225,34.67,6.53
Tender_856,5550206,3806884,1930716,149246,342487,11779539,39.0,6.1
Tender_857,4991807,766942,921552,547364,61875,7289540,35.67,6.43
Tender_858,4922122,2353681,448208,745107,291943,8761061,38.33,6.17
Tender_859,651025,3404808,1052949,476490,214883,5800155,41.67,5.83
Tender_860,5828112,4049268,2000883,729786,171083,12779132,30.0,7.0
Tender_861,5188091,2060529,628521,810937,236081,8924159,42.33,5.77
Tender_862,8358603,1827256,1810016,142254,490058,12628187,48.67,5.13
Tender_863,5618387,507073,1441733,645619,498685,8711497,51.33,4.87
Tender_864,6103647,1391080,345182,548835,456840,8845584,30.33,6.97
Tender_865,3423905,1124357,614735,278024,463790,5904811,26.67,7.33
Tender_866,3268452,2136596,1409731,61127,400897,7276803,51.0,4.9
Tender_867,5148602,3811577,1361223,166932,364119,10852453,27.33,7.27
Tender_868,2092232,432910,2402855,369555,192193,5489745,33.0,6.7
Tender_869,3579859,1044077,1478454,722065,317483,7141938,39.33,6.07
Tender_870,7263473,4479147,2018153,123665,138305,14022743,48.33,5.17
Tender_871,880549,1881540,2644529,148658,311683,5866959,50.67,4.93
Tender_872,8199579,1411255,2476326,150125,88680,12325965,30.33,6.97
Tender_873,773979,4175313,633558,97529,448348,6128727,50.0,5.0
Tender_874,2853244,2299893,1616980,905137,457219,8132473,26.67,7.33
Tender_875,5222620,193381,597112,700643,471898,7185654,26.67,7.33
Tender_876,9995716,1724331,1083075,358968,387568,13549658,39.0,6.1
Tender_877,2167808,1080028,1157045,754474,249461,5408816,21.33,7.87
Tender_878,4854353,3765679,2688879,993072,340877,12642860,47.33,5.27
Tender_879,1964102,2524389,250454,673621,492911,5905477,34.33,6.57
Tender_880,411365,4108378,810895,576807,116331,6023776,24.33,7.57
Tender_881,8080737,2349085,2945741,650442,83184,14109189,54.67,4.53
Tender_882,1845052,2128072,404652,696743,170785,5245304,43.33,5.67
Tender_883,8118400,2283710,555784,57413,169874,11185181,30.67,6.93
Tender_884,9444210,820635,2574767,749389,337350,13926351,33.67,6.63
Tender_885,7902809,4614608,2616612,396190,235923,15766142,37.0,6.3
Tender_886,8827034,4552312,303907,481830,99973,14265056,38.0,6.2
Tender_887,9678541,1025685,1729456,545856,250030,13229568,36.0,6.4
Tender_888,7258285,3123450,1250391,682333,277253,12591712,32.0,6.8
Tender_889,8517176,3847479,932526,996673,153783,14447637,46.0,5.4
Tender_890,6177184,3697089,1841655,831359,463245,13010532,44.67,5.53
Tender_891,3617878,3213668,2670236,625013,108187,10234982,31.67,6.83
Tender_892,6620561,796494,1892390,402047,319091,10030583,30.0,7.0
Tender_893,372986,3235617,1970475,578866,188320,6346264,40.0,6.0
Tender_894,209172,610349,2474366,972957,353064,4619908,38.33,6.17
Tender_895,4829749,1293251,1244843,480990,340917,8189750,25.33,7.47
Tender_896,5457955,911691,1127620,322105,170457,7989828,39.67,6.03
Tender_897,5297206,4391797,1958511,934687,199773,12781974,42.33,5.77
Tender_898,5935069,3465921,2817450,769937,113903,13102280,42.33,5.77
Tender_899,8556838,2287197,2003556,684921,151435,13683947,29.67,7.03
Tender_900,4930558,2957975,1252443,112149,206123,9459248,29.33,7.07
Tender_901,2543646,4799064,2540845,572332,244286,10700173,31.67,6.83
Tender_902,8525485,1264664,731250,699204,479959,11700562,43.33,5.67
Tender_903,6403126,821113,2844863,459347,302323,10830772,45.0,5.5
Tender_904,4062783,4924569,234274,174074,489729,9885429,23.33,7.67
Tender_905,8018799,2640447,1514449,613299,483362,13270356,34.0,6.6
Tender_906,3800623,1081578,211796,373792,76465,5544254,45.67,5.43
Tender_907,7829379,3161383,947722,853014,344791,13136289,34.67,6.53
Tender_908,3683598,808363,480977,812325,103347,5888610,56.67,4.33
Tender_909,2988035,4087164,2398564,104857,309157,9887777,31.67,6.83
Tender_910,6852021,3524288,781720,333666,298115,11789810,25.33,7.47
Tender_911,9855168,2164361,2073927,244997,215713,14554166,39.0,6.1
Tender_912,5992919,4391939,1039825,728418,406431,12559532,26.67,7.33
Tender_913,3574218,3526831,1632902,154023,411389,9299363,24.67,7.53
Tender_914,7766817,841430,2477600,905349,164333,12155529,25.33,7.47
Tender_915,2670125,4729026,2823453,146674,202774,10572052,35.67,6.43
Tender_916,4490011,327382,2854851,487893,159618,8319755,44.0,5.6
Tender_917,5439859,4702478,782991,800700,165367,11891395,33.0,6.7
Tender_918,4796547,3036533,494395,270070,298185,8895730,31.67,6.83
Tender_919,9753139,2625868,2599106,278366,198707,15455186,31.0,6.9
Tender_920,8191068,165580,475378,336810,298980,9467816,37.0,6.3
Tender_921,2220050,1970679,2942248,744006,459036,8336019,48.67,5.13
Tender_922,2941831,616644,1850938,111622,376246,5897281,45.67,5.43
Tender_923,2867697,1733415,2060465,178518,398630,7238725,40.33,5.97
Tender_924,6536233,1303562,1991876,502057,393920,10727648,32.33,6.77
Tender_925,5475937,3108842,397742,467974,429979,9880474,42.67,5.73
Tender_926,1426670,1961656,174418,310154,353256,4226154,31.33,6.87
Tender_927,5067132,3204319,2249260,276561,441558,11238830,40.0,6.0
Tender_928,4262331,2806598,1713234,979135,196173,9957471,38.0,6.2
Tender_929,7185011,2868303,1704670,150893,443234,12352111,35.67,6.43
Tender_930,2921158,3125316,2466348,290926,494888,9298636,40.0,6.0
Tender_931,980321,1743519,1211492,677807,216929,4830068,42.0,5.8
Tender_932,1208830,3867269,1929231,268855,240187,7514372,50.0,5.0
Tender_933,9927286,1618762,2573602,280970,455869,14856489,46.67,5.33
Tender_934,1817284,192750,1087859,858053,167215,4123161,28.0,7.2
Tender_935,2612430,2822261,2361585,547681,63935,8407892,49.0,5.1
Tender_936,6003610,3572166,281058,253285,356032,10466151,25.0,7.5
Tender_937,8772276,232814,585434,471665,243868,10306057,30.33,6.97
Tender_938,6470343,125912,2384366,129653,125159,9235433,46.0,5.4
Tender_939,4154922,3603441,876682,569387,380911,9585343,39.33,6.07
Tender_940,5434120,2564782,2522338,654132,298917,11474289,41.33,5.87
Tender_941,1057419,1274462,638639,622822,268484,3861826,34.67,6.53
Tender_942,2455178,118763,1994689,357035,103556,5029221,49.0,5.1
Tender_943,8328011,1555153,2329933,324690,409059,12946846,36.67,6.33
Tender_944,483072,1292346,480509,720820,176107,3152854,30.33,6.97
Tender_945,8722882,3139919,2023283,608737,339122,14833943,48.33,5.17
Tender_946,9861396,4863504,2249112,659232,51086,17684330,29.33,7.07
Tender_947,6149762,4225599,2488651,683006,481708,14028726,18.33,8.17
Tender_948,4160765,2170386,1540481,577458,82495,8531585,50.0,5.0
Tender_949,8715904,3577762,2869526,901107,421615,16485914,27.33,7.27
Tender_950,8121642,3990756,785857,262635,245759,13406649,37.0,6.3
Tender_951,570288,496950,2029717,439711,264358,3801024,20.0,8.0
Tender_952,7502818,3839174,2206367,618684,174779,14341822,37.33,6.27
Tender_953,4561690,826011,1867527,998563,185246,8439037,30.67,6.93
Tender_954,789290,458169,2463871,563163,287242,4561735,35.0,6.5
Tender_955,1485251,3364456,50837,373151,194392,5468087,46.33,5.37
Tender_956,3644726,285081,2725634,731699,411884,7799024,47.67,5.23
Tender_957,8489190,936544,870879,331715,463175,11091503,59.67,4.03
Tender_958,4721728,816485,177860,602156,415190,6733419,37.0,6.3
Tender_959,9501954,2051226,2708504,406549,174461,14842694,39.67,6.03
Tender_960,9842414,136329,155682,260901,330898,10726224,41.67,5.83
Tender_961,6776929,1978685,1353707,176616,130416,10416353,33.0,6.7
Tender_962,8584512,1238853,1497110,950055,342287,12612817,43.67,5.63
Tender_963,9540372,1460753,454160,195483,430393,12081161,19.0,8.1
Tender_964,2385274,1870816,768633,331068,312413,5668204,31.0,6.9
Tender_965,7388393,1438232,2509351,851463,122132,12309571,29.67,7.03
Tender_966,3935043,2195124,1903125,116133,224672,8374097,35.0,6.5
Tender_967,8425404,3076363,2633366,571707,348361,15055201,42.33,5.77
Tender_968,6579467,2656759,2880723,954640,368267,13439856,29.33,7.07
Tender_969,2319933,1977234,2542046,816686,297575,7953474,51.67,4.83
Tender_970,4610755,1767801,477764,442393,332551,7631264,49.33,5.07
Tender_971,6872198,4243784,1787452,700100,241843,13845377,40.33,5.97
Tender_972,1361721,2276379,1973539,839984,209270,6660893,40.33,5.97
Tender_973,305436,2772867,439855,888307,234376,4640841,51.0,4.9
Tender_974,5752092,1842840,1678758,162320,466503,9902513,36.67,6.33
Tender_975,9787642,3704645,364932,888739,231736,14977694,39.0,6.1
Tender_976,4287844,2909945,1083537,968897,216314,9466537,44.33,5.57
Tender_977,2073689,3447988,2066903,764994,59428,8413002,54.67,4.53
Tender_978,9356485,415559,211416,488199,212524,10684183,35.0,6.5
Tender_979,586010,1253484,479482,356137,489271,3164384,59.0,4.1
Tender_980,5141352,3373215,2162196,998405,107181,11782349,25.0,7.5
Tender_981,5235119,4089389,2895886,848716,454765,13523875,56.67,4.33
Tender_982,8326473,2715981,560143,868748,215039,12686384,33.0,6.7
Tender_983,4981322,937567,459482,638472,337207,7354050,36.33,6.37
Tender_984,630364,1544471,146949,948591,449339,3719714,35.0,6.5
Tender_985,5696131,777725,1912966,991611,304874,9683307,57.67,4.23
Tender_986,838783,3417253,895277,721386,388565,6261264,38.67,6.13
Tender_987,5704670,1949599,1524112,762625,365015,10306021,27.67,7.23
Tender_988,1934882,4363757,1508624,689498,463845,8960606,29.0,7.1
Tender_989,5794260,1486579,762153,931113,64843,9038948,30.33,6.97
Tender_990,4783613,2204694,2118810,841690,460792,10409599,39.33,6.07
Tender_991,414114,2736168,2206526,535701,196718,6089227,35.67,6.43
Tender_992,7064274,4997073,1125239,719851,314822,14221259,21.0,7.9
Tender_993,1218338,3310750,1590662,75156,472128,6667034,42.33,5.77
Tender_994,4268927,1665363,553574,347285,77369,6912518,26.33,7.37
Tender_995,5738094,1506653,651235,503396,249448,8648826,30.0,7.0
Tender_996,7243565,2003174,1908163,783170,70786,12008858,27.33,7.27
Tender_997,2904319,4191856,315470,862955,456938,8731538,55.0,4.5
Tender_998,7939352,1300485,61130,368867,259753,9929587,34.33,6.57
Tender_999,378934,2435064,1603164,814381,295459,5527002,39.0,6.1
Tender_1000,6663337,4608387,2813494,69353,477882,14632453,45.67,5.43
Tender_1001,1465434,2302999,2998588,902330,394280,8063631,37.0,6.3
Tender_1002,497595,1926853,967379,106453,362309,3860589,17.0,8.3
Tender_1003,6273248,4899513,2863469,170726,431772,14638728,37.0,6.3
Tender_1004,864231,3687362,2149672,855683,143943,7700891,47.0,5.3
Tender_1005,1176388,514636,2978009,823328,196850,5689211,34.67,6.53
Tender_1006,1861929,3286872,2295954,339032,421497,8205284,42.0,5.8
Tender_1007,8344644,554756,903660,994861,186858,10984779,40.33,5.97
Tender_1008,1959881,3947245,1343834,668337,366866,8286163,27.33,7.27
Tender_1009,6295713,4985343,2627472,132380,413111,14454019,39.67,6.03
Tender_1010,4304264,1696012,2892255,259300,168832,9320663,43.0,5.7
Tender_1011,7595979,4969696,2327397,311589,369584,15574245,51.0,4.9
Tender_1012,2704698,765535,1920883,561534,117350,6070000,34.33,6.57
Tender_1013,9529326,134179,2869752,102581,151289,12787127,20.0,8.0
Tender_1014,1812030,3034897,1997730,645781,95575,7586013,34.67,6.53
Tender_1015,7938084,902548,2338410,716782,341017,12236841,38.0,6.2
Tender_1016,8302178,3062835,2778888,331138,120377,14595416,35.0,6.5
Tender_1017,4597122,358777,2600619,538528,53781,8148827,44.67,5.53
Tender_1018,302034,3956481,1188784,983783,222740,6653822,30.33,6.97
Tender_1019,9561591,684972,508350,939383,497649,12191945,32.33,6.77
Tender_1020,9557914,601306,1505489,223882,365111,12253702,33.0,6.7
Tender_1021,8999137,4552752,1672345,465025,77166,15766425,24.33,7.57
Tender_1022,5425641,749616,2045981,196157,207140,8624535,27.0,7.3
Tender_1023,8142987,3558119,2536216,165407,258872,14661601,49.0,5.1
Tender_1024,9887879,3206844,1910364,959051,335840,16299978,30.67,6.93
Tender_1025,7605736,1778268,2910097,456368,434767,13185236,48.0,5.2
Tender_1026,6298705,2963881,2921320,915997,205309,13305212,29.0,7.1
Tender_1027,3760325,4923577,2221047,297650,482160,11684759,42.67,5.73
Tender_1028,1456714,4568981,142023,120857,73278,6361853,28.0,7.2
Tender_1029,2171066,3137186,2172895,404562,460735,8346444,27.33,7.27
Tender_1030,6282403,628758,1870672,541273,315330,9638436,42.33,5.77
Tender_1031,5073020,3163706,2350281,534287,412442,11533736,36.67,6.33
Tender_1032,5608469,1787355,1297385,864788,352525,9910522,43.67,5.63
Tender_1033,1275148,1399277,2002850,491617,204179,5373071,38.67,6.13
Tender_1034,7264203,619820,1758046,141525,465993,10249587,46.67,5.33
Tender_1035,5215796,1531503,576654,419277,51067,7794297,24.33,7.57
Tender_1036,3799716,4784397,1475191,534534,374577,10968415,48.0,5.2
Tender_1037,4293061,2016173,2970268,352234,185237,9816973,44.33,5.57
Tender_1038,9070460,3221211,2467249,958170,153534,15870624,24.67,7.53
Tender_1039,2387839,2093095,2458029,890598,188781,8018342,41.33,5.87
Tender_1040,8916513,2383193,1734903,283043,309046,13626698,33.67,6.63
Tender_1041,9168320,1365146,1937629,416953,476173,13364221,30.67,6.93
Tender_1042,4140961,2407841,743785,393265,190115,7875967,43.67,5.63
Tender_1043,6671716,2880917,1092610,723158,496545,11864946,31.0,6.9
Tender_1044,7948429,175390,876598,163258,306144,9469819,26.67,7.33
Tender_1045,226534,771664,1333403,285519,376442,2993562,38.0,6.2
Tender_1046,880018,2777982,1670093,450154,453671,6231918,51.67,4.83
Tender_1047,7835630,1529339,2777758,320085,436426,12899238,50.0,5.0
Tender_1048,4430312,4566498,355442,875235,304300,10531787,26.67,7.33
Tender_1049,1962327,222125,2955607,677888,346828,6164775,35.0,6.5
Tender_1050,9463520,543128,2012721,301333,303981,12624683,45.67,5.43
Tender_1051,9397174,3596835,2195767,707968,320353,16218097,55.67,4.43
Tender_1052,7164467,2306456,2438747,67269,128923,12105862,44.33,5.57
Tender_1053,9451616,4522636,459196,156067,270423,14859938,34.0,6.6
Tender_1054,2503553,3531021,2110886,921728,317471,9384659,47.67,5.23
Tender_1055,9464403,1124759,2049211,452824,272810,13364007,62.67,3.73
Tender_1056,8440861,2731601,404743,889961,131610,12598776,41.0,5.9
Tender_1057,6115225,3848623,283576,701916,205049,11154389,32.33,6.77
Tender_1058,8413149,3930859,2897556,764938,219660,16226162,33.33,6.67
Tender_1059,1810405,4981512,2754881,346004,322123,10214925,32.0,6.8
Tender_1060,9291479,1875683,708515,836118,151824,12863619,27.33,7.27
Tender_1061,9374357,1651704,303624,439675,87858,11857218,32.67,6.73
Tender_1062,7914743,2348734,914460,978307,408791,12565035,41.0,5.9
Tender_1063,3339187,3479532,2085797,197115,205266,9306897,24.67,7.53
Tender_1064,3444358,3457506,2291335,643761,68377,9905337,29.67,7.03
Tender_1065,1072132,2330532,1870799,820284,352812,6446559,58.0,4.2
Tender_1066,7567639,1529555,1133756,945208,111323,11287481,31.0,6.9
Tender_1067,5920722,4489527,509548,708372,409428,12037597,44.0,5.6
Tender_1068,6022209,3736201,571041,500802,385269,11215522,42.67,5.73
Tender_1069,8141725,1787379,2325876,511275,281832,13048087,46.67,5.33
Tender_1070,9414709,4530382,2631168,729108,107754,17413121,48.67,5.13
Tender_1071,7025855,4818993,2921896,220737,191552,15179033,39.67,6.03
Tender_1072,1779163,4943576,1287980,373807,303224,8687750,47.0,5.3
Tender_1073,6567719,3553037,1948989,715032,141671,12926448,29.67,7.03
Tender_1074,5512396,4369371,1183022,298437,280856,11644082,48.67,5.13
Tender_1075,9498527,190982,2024731,353742,68077,12136059,43.67,5.63
Tender_1076,4430663,966697,376898,737307,173723,6685288,40.67,5.93
Tender_1077,1882467,1649826,1969827,564178,454348,6520646,43.33,5.67
Tender_1078,3497353,3634367,2413603,959308,375589,10880220,30.67,6.93
Tender_1079,310523,3264093,2448008,959201,153826,7135651,54.0,4.6
Tender_1080,821003,4882699,887408,83013,358964,7033087,40.33,5.97
Tender_1081,3628165,1716113,2259359,135414,238666,7977717,38.33,6.17
Tender_1082,2901014,554383,2274338,374552,189264,6293551,29.0,7.1
Tender_1083,2953105,384670,1739684,691754,378977,6148190,40.0,6.0
Tender_1084,564842,2786218,2212401,229832,358918,6152211,41.0,5.9
Tender_1085,7041722,2711458,1103961,521747,432643,11811531,39.67,6.03
Tender_1086,5104058,3841884,2291149,650951,341632,12229674,31.67,6.83
Tender_1087,6941657,3479147,2090794,153950,391736,13057284,47.0,5.3
Tender_1088,3184801,2445817,2308895,102748,177273,8219534,42.0,5.8
Tender_1089,561007,1515751,1781672,873103,218184,4949717,38.0,6.2
Tender_1090,7247219,2514652,1089016,972832,155852,11979571,41.67,5.83
Tender_1091,7383660,2381718,2384991,220711,170354,12541434,37.67,6.23
Tender_1092,8389171,2674798,726071,828997,264107,12883144,56.67,4.33
Tender_1093,3085413,1290631,1182408,444595,123586,6126633,30.0,7.0
Tender_1094,8609249,4817541,1687145,696760,128103,15938798,29.67,7.03
Tender_1095,4233204,1595851,2552069,936522,375889,9693535,27.67,7.23
Tender_1096,7191741,4630900,2342763,962804,275460,15403668,32.67,6.73
Tender_1097,1624383,858091,1916549,573628,306829,5279480,53.0,4.7
Tender_1098,5320935,4415928,429353,883336,294527,11344079,48.0,5.2
Tender_1099,1582057,1708208,2690321,376297,220028,6576911,44.0,5.6
Tender_1100,685989,1396708,1774066,972778,78363,4907904,39.67,6.03
Tender_1101,3246255,2929323,2289147,751412,278866,9495003,35.67,6.43
Tender_1102,8641226,3149343,1523584,940051,153570,14407774,22.33,7.77
Tender_1103,3178858,791004,1520043,204634,434418,6128957,33.33,6.67
Tender_1104,6966484,1427617,329145,581853,434544,9739643,53.0,4.7
Tender_1105,3576357,3249727,989504,697941,301273,8814802,19.33,8.07
Tender_1106,8771905,3415896,406752,921846,393580,13909979,30.33,6.97
Tender_1107,276592,650246,735627,74137,412011,2148613,40.0,6.0
Tender_1108,3163547,4163054,2083661,459311,370379,10239952,47.0,5.3
Tender_1109,7507888,4602266,2705752,466577,163410,15445893,44.33,5.57
Tender_1110,5434790,1626512,2902359,645686,444386,11053733,41.33,5.87
Tender_1111,2778153,3782139,2017258,84268,141176,8802994,51.67,4.83
Tender_1112,9581336,1418867,945329,335020,421782,12702334,42.67,5.73
Tender_1113,1115045,3946825,383432,481714,389267,6316283,54.0,4.6
Tender_1114,4074059,1653866,1434025,301608,229908,7693466,37.0,6.3
Tender_1115,1450380,1043289,586220,922614,243125,4245628,43.33,5.67
Tender_1116,6013088,2106064,2297481,711715,187945,11316293,35.33,6.47
Tender_1117,2000208,3738558,411623,504833,351421,7006643,52.0,4.8
Tender_1118,2904206,286264,1552201,347642,74251,5164564,32.0,6.8
Tender_1119,3048087,4771529,2598325,267603,184629,10870173,32.67,6.73
Tender_1120,7428132,3405473,53409,114360,107416,11108790,32.67,6.73
Tender_1121,5491799,3690786,1218962,320182,425223,11146952,25.33,7.47
Tender_1122,9028022,261975,853320,336183,470281,10949781,31.67,6.83
Tender_1123,1628442,1512508,1753389,814800,440311,6149450,50.67,4.93
Tender_1124,7609846,1183244,2733615,695698,335495,12557898,49.33,5.07
Tender_1125,7963493,3474853,446129,540119,211208,12635802,31.33,6.87
Tender_1126,3129390,2019747,638450,850829,238733,6877149,36.67,6.33
Tender_1127,9957052,721629,2539824,898922,315732,14433159,30.33,6.97
Tender_1128,3295888,3542912,490434,687886,441634,8458754,31.0,6.9
Tender_1129,5987298,3083362,1417169,500634,430225,11418688,38.0,6.2
Tender_1130,8055600,502595,2964955,733885,259219,12516254,49.0,5.1
Tender_1131,9112820,1083021,544242,703634,133834,11577551,31.33,6.87
Tender_1132,3508375,1615296,2894259,572416,154723,8745069,51.0,4.9
Tender_1133,7317242,2407333,1672117,998995,347323,12743010,35.33,6.47
Tender_1134,4127557,600004,938403,528916,90443,6285323,30.33,6.97
Tender_1135,7169185,2581707,2583470,727546,153152,13215060,27.0,7.3
Tender_1136,9112319,183107,2993261,909234,375180,13573101,33.33,6.67
Tender_1137,1996424,1852135,1252714,148555,253891,5503719,41.33,5.87
Tender_1138,2338160,2718083,1477585,975006,308797,7817631,42.33,5.77
Tender_1139,3933502,912165,409749,957378,282266,6495060,51.0,4.9
Tender_1140,491092,4126504,2898319,381299,211079,8108293,39.0,6.1
Tender_1141,5659087,3604101,726626,512532,177254,10679600,56.67,4.33
Tender_1142,3894115,133876,2339537,454517,184394,7006439,38.0,6.2
Tender_1143,2691451,4194789,1470005,97696,403084,8857025,36.67,6.33
Tender_1144,5691521,1057675,2972768,477527,496932,10696423,26.0,7.4
Tender_1145,2521812,1781757,2221491,561987,377993,7465040,30.0,7.0
Tender_1146,7340608,4294066,2414290,878481,105070,15032515,28.0,7.2
Tender_1147,1015812,4104285,361504,741970,479580,6703151,45.33,5.47
Tender_1148,883970,4129357,862454,56453,390688,6322922,29.33,7.07
Tender_1149,1348840,1916644,68542,68485,190360,3592871,43.33,5.67
Tender_1150,1687572,4460076,2155029,839135,247292,9389104,50.0,5.0
Tender_1151,9250357,3276753,2561231,823571,281099,16193011,44.67,5.53
Tender_1152,1994884,2596979,2217304,145000,87464,7041631,35.67,6.43
Tender_1153,3306084,284923,397429,232589,311013,4532038,35.33,6.47
Tender_1154,4300888,2295799,2136749,760514,393551,9887501,31.0,6.9
Tender_1155,478055,4006537,2655741,626486,55442,7822261,30.67,6.93
Tender_1156,8255772,356961,472437,71763,85828,9242761,36.0,6.4
Tender_1157,3764362,2379316,550126,72887,279063,7045754,38.0,6.2
Tender_1158,9006745,1370354,2994398,200363,206426,13778286,25.67,7.43
Tender_1159,9029572,463387,1418824,364195,219447,11495425,32.0,6.8
Tender_1160,9619779,4660282,2596809,255582,138952,17271404,27.0,7.3
Tender_1161,1226553,3654950,2839519,122459,439914,8283395,42.33,5.77
Tender_1162,1482785,3491244,2192111,945787,303074,8415001,31.0,6.9
Tender_1163,2578531,2592414,1924075,633258,160113,7888391,38.67,6.13
Tender_1164,2992709,4240759,651307,904899,233125,9022799,35.67,6.43
Tender_1165,1664755,4555620,1155877,137656,124374,7638282,52.67,4.73
Tender_1166,2485158,3611338,2261947,88223,381485,8828151,39.0,6.1
Tender_1167,4627729,1681811,933447,65947,447120,7756054,49.0,5.1
Tender_1168,3535575,3151811,1262650,692487,366536,9009059,39.0,6.1
Tender_1169,7167787,2348709,1035064,580818,483195,11615573,57.33,4.27
Tender_1170,6074853,2190978,273528,218850,57857,8816066,53.67,4.63
Tender_1171,2341452,214949,2687800,813565,85230,6142996,47.67,5.23
Tender_1172,1796146,737111,1767284,723076,167870,5191487,39.0,6.1
Tender_1173,1209673,1347142,2022512,432587,158548,5170462,53.67,4.63
Tender_1174,1499116,1185911,1294637,781224,203600,4964488,49.0,5.1
Tender_1175,732455,3351723,324183,982253,422456,5813070,51.0,4.9
Tender_1176,7631175,2624336,1707532,276904,441858,12681805,23.33,7.67
Tender_1177,4776050,1088722,2100541,274065,168997,8408375,31.33,6.87
Tender_1178,5779838,2821228,533649,377645,430006,9942366,30.33,6.97
Tender_1179,3194301,2146883,579255,280438,251790,6452667,30.33,6.97
Tender_1180,990257,2812335,1038220,469417,357500,5667729,32.33,6.77
Tender_1181,6038757,2208932,2538590,405319,206198,11397796,29.67,7.03
Tender_1182,1059479,1762823,2249003,962285,251710,6285300,32.33,6.77
Tender_1183,777675,1121037,2351388,956361,201421,5407882,37.0,6.3
Tender_1184,9874163,4331422,2614970,692419,230537,17743511,42.67,5.73
Tender_1185,1541816,4051613,479292,820413,347882,7241016,36.67,6.33
Tender_1186,1321323,207380,948624,350232,199920,3027479,44.33,5.57
Tender_1187,7942766,3008196,2579739,519181,184838,14234720,28.0,7.2
Tender_1188,2158709,437637,2676536,62824,240905,5576611,48.67,5.13
Tender_1189,5594860,4710534,2532027,237227,77088,13151736,35.0,6.5
Tender_1190,8663247,1460011,2142200,639527,52500,12957485,38.67,6.13
Tender_1191,671922,1329779,2617669,179260,207908,5006538,42.0,5.8
Tender_1192,8767258,647592,1688045,724087,65625,11892607,24.0,7.6
Tender_1193,6432360,3511379,2277912,476112,106520,12804283,45.67,5.43
Tender_1194,2270013,1263872,2280550,242970,284640,6342045,36.67,6.33
Tender_1195,1597737,3243817,2070321,747221,287027,7946123,44.67,5.53
Tender_1196,1260560,1962248,2196926,295406,481137,6196277,33.67,6.63
Tender_1197,5616279,1555673,2638158,452277,412804,10675191,52.0,4.8
Tender_1198,590067,1616806,2591744,397722,267663,5464002,50.0,5.0
Tender_1199,5279832,2404747,2127198,925290,290493,11027560,42.0,5.8
Tender_1200,1999818,173070,792498,645750,476065,4087201,38.33,6.17
Tender_1201,2977335,4466618,1201034,810983,245994,9701964,47.67,5.23
Tender_1202,2911208,2571965,873977,399881,122730,6879761,43.0,5.7
Tender_1203,5964267,237815,2115464,495950,66849,8880345,35.67,6.43
Tender_1204,1199878,4277360,574573,534595,52785,6639191,43.0,5.7
Tender_1205,1471902,2571201,1349374,781950,172478,6346905,30.67,6.93
Tender_1206,2104751,4916722,2958773,704725,211165,10896136,38.0,6.2
Tender_1207,2994447,1769487,2729260,651148,352815,8497157,50.0,5.0
Tender_1208,8650051,4552581,2953045,939157,365985,17460819,31.0,6.9
Tender_1209,7844015,2138217,937928,551612,434439,11906211,34.33,6.57
Tender_1210,5761686,2322897,1871058,116341,188797,10260779,42.33,5.77
Tender_1211,1206136,770815,2007752,342104,409321,4736128,51.33,4.87
Tender_1212,8945891,3514854,1461263,793294,84485,14799787,33.67,6.63
Tender_1213,3248503,1274899,581368,752654,457853,6315277,37.67,6.23
Tender_1214,6831687,2133679,900284,956885,108434,10930969,42.33,5.77
Tender_1215,8043793,1320613,1590010,870629,214893,12039938,41.33,5.87
Tender_1216,897043,2787376,1792653,768762,116990,6362824,33.0,6.7
Tender_1217,3473530,1214259,1064191,848792,368631,6969403,32.0,6.8
Tender_1218,9697830,4377073,2007989,506682,349930,16939504,33.67,6.63
Tender_1219,1122485,4291677,471728,587573,134008,6607471,29.0,7.1
Tender_1220,8337257,2417719,116528,838750,261208,11971462,35.33,6.47
Tender_1221,4331966,2685659,2835002,815758,203361,10871746,44.33,5.57
Tender_1222,9556918,315631,2710944,439444,210776,13233713,31.67,6.83
Tender_1223,338883,1276201,2933650,521056,76381,5146171,29.33,7.07
Tender_1224,7562240,4876641,2194982,331468,341957,15307288,42.0,5.8
Tender_1225,1788809,1042236,2908932,882088,381769,7003834,35.67,6.43
Tender_1226,4968917,1749826,2415199,655173,181306,9970421,49.33,5.07
Tender_1227,4236857,1867795,1908720,365355,100111,8478838,39.0,6.1
Tender_1228,8468682,1240842,850294,403378,59534,11022730,36.67,6.33
Tender_1229,2003051,1373792,901250,221602,427181,4926876,32.33,6.77
Tender_1230,1764420,4114302,1484589,593522,332868,8289701,57.33,4.27
Tender_1231,728734,3648214,1799629,620661,246638,7043876,13.33,8.67
Tender_1232,4828143,271676,364585,860362,478488,6803254,45.0,5.5
Tender_1233,6405462,1836415,862361,720534,297741,10122513,51.67,4.83
Tender_1234,2059407,1612320,2715663,216323,130997,6734710,44.67,5.53
Tender_1235,5283353,1133037,2839500,384857,200404,9841151,32.33,6.77
Tender_1236,2251285,4820283,88281,838160,65322,8063331,48.0,5.2
Tender_1237,4491958,967780,2282401,99761,400044,8241944,27.67,7.23
Tender_1238,6599465,3545749,1450662,983670,164613,12744159,43.0,5.7
Tender_1239,9227399,2841794,640282,621686,59254,13390415,36.33,6.37
Tender_1240,8616915,4298580,1272510,867356,224627,15279988,60.0,4.0
Tender_1241,2228211,417281,2136668,991657,412386,6186203,44.67,5.53
Tender_1242,8501664,3358802,373366,281510,396553,12911895,40.67,5.93
Tender_1243,5536194,2264164,2465507,954816,390800,11611481,18.0,8.2
Tender_1244,7070966,1889581,1619315,263362,182106,11025330,46.33,5.37
Tender_1245,1277325,4394495,1009547,706411,274030,7661808,38.67,6.13
Tender_1246,906846,3214866,1520040,807201,239423,6688376,37.67,6.23
Tender_1247,9696259,2882213,930862,466563,337509,14313406,30.0,7.0
Tender_1248,6060977,629003,237665,537960,397407,7863012,47.67,5.23
Tender_1249,9520439,1264566,1958893,593208,310116,13647222,40.0,6.0
Tender_1250,4014681,4981087,1936357,93839,325588,11351552,33.67,6.63
Tender_1251,5163481,4353329,594775,743176,281503,11136264,34.0,6.6
Tender_1252,9250420,3659078,550255,644720,459693,14564166,28.33,7.17
Tender_1253,4216828,3485024,2204868,212558,204474,10323752,49.67,5.03
Tender_1254,5892692,2079973,2006995,223327,387226,10590213,61.67,3.83
Tender_1255,1297612,1043797,495492,949186,478958,4265045,34.33,6.57
Tender_1256,2870815,4435521,1635036,538172,433578,9913122,48.33,5.17
Tender_1257,8044527,353297,2829656,972876,491824,12692180,27.33,7.27
Tender_1258,5831889,2809159,872747,250931,281595,10046321,30.0,7.0
Tender_1259,4022466,4365544,1275111,430483,276378,10369982,38.67,6.13
Tender_1260,7196556,2152883,1363709,411251,312218,11436617,42.33,5.77
Tender_1261,3301578,170553,2761308,614881,213882,7062202,39.33,6.07
Tender_1262,5252891,3887227,2091835,526305,94870,11853128,38.33,6.17
Tender_1263,8135730,3377145,2201560,660262,346090,14720787,32.0,6.8
Tender_1264,1138894,342793,1163655,543629,176436,3365407,35.33,6.47
Tender_1265,6138509,2584644,2203251,518512,481085,11926001,28.67,7.13
Tender_1266,3273568,3251198,1017059,203465,428505,8173795,31.0,6.9
Tender_1267,4051280,1778731,2432691,699611,127186,9089499,27.0,7.3
Tender_1268,3436545,2750904,2428971,590257,361057,9567734,35.0,6.5
Tender_1269,5365151,293595,2027730,903964,338520,8928960,30.33,6.97
Tender_1270,8193901,4277038,1266368,696911,278307,14712525,56.67,4.33
Tender_1271,5863911,4074386,543990,577848,149657,11209792,36.33,6.37
Tender_1272,426612,2051318,953739,515385,147720,4094774,53.67,4.63
Tender_1273,9883215,1016892,1575503,207945,290342,12973897,55.33,4.47
Tender_1274,1374816,4693134,1026302,405117,164630,7663999,49.33,5.07
Tender_1275,8320616,4599348,562467,481663,90842,14054936,39.67,6.03
Tender_1276,9438450,2934226,596095,661168,108465,13738404,36.33,6.37
Tender_1277,3442142,2079082,842646,947981,377735,7689586,34.33,6.57
Tender_1278,6173535,4024924,2906356,962761,132187,14199763,21.33,7.87
Tender_1279,7275179,3953827,1140975,248227,365943,12984151,52.33,4.77
Tender_1280,3411939,3134851,1758692,896506,342726,9544714,38.33,6.17
Tender_1281,6527358,2112843,2704453,752012,133613,12230279,20.33,7.97
Tender_1282,4732207,1929244,2561245,786780,387055,10396531,27.33,7.27
Tender_1283,788760,3047318,753973,554138,350675,5494864,27.33,7.27
Tender_1284,6392456,2262503,2416338,367482,447053,11885832,58.33,4.17
Tender_1285,9049171,473493,2107027,483764,338299,12451754,32.33,6.77
Tender_1286,5746311,4881909,2196570,615708,322349,13762847,31.33,6.87
Tender_1287,8689176,2743294,998073,742925,173022,13346490,34.33,6.57
Tender_1288,9471609,2146950,1907526,446141,316936,14289162,28.33,7.17
Tender_1289,1425735,1721072,258740,307296,52922,3765765,47.67,5.23
Tender_1290,1883708,1522569,349231,658040,451089,4864637,48.33,5.17
Tender_1291,9349292,2329840,601994,940322,415132,13636580,28.67,7.13
Tender_1292,6426123,2178250,1225029,912907,194149,10936458,41.33,5.87
Tender_1293,6075923,1753503,2105520,792131,107718,10834795,52.67,4.73
Tender_1294,7753210,2846603,550967,577013,263274,11991067,34.33,6.57
Tender_1295,8171835,260379,300618,340788,366506,9440126,46.33,5.37
Tender_1296,1623782,3398656,436517,714012,377420,6550387,38.33,6.17
Tender_1297,8100349,4930712,249562,87948,156850,13525421,50.33,4.97
Tender_1298,592502,4513984,991935,430891,289604,6818916,38.0,6.2
Tender_1299,7624060,2534597,2187973,381171,267075,12994876,28.0,7.2
Tender_1300,7771738,2649935,1064298,270160,442617,12198748,35.67,6.43
Tender_1301,6253980,2140437,2766860,559979,372251,12093507,41.33,5.87
Tender_1302,8124836,1929421,952250,239220,281680,11527407,35.33,6.47
Tender_1303,7350870,4441387,975397,578230,52368,13398252,43.67,5.63
Tender_1304,7471396,268219,400530,440436,314836,8895417,22.33,7.77
Tender_1305,2411008,1447526,389268,601953,276236,5125991,39.0,6.1
Tender_1306,7949161,2817369,708109,276768,171579,11922986,31.0,6.9
Tender_1307,1396516,2329463,2521418,645876,136069,7029342,23.67,7.63
Tender_1308,1178932,4285951,1933739,301091,352340,8052053,35.67,6.43
Tender_1309,6742143,850150,2595523,749431,236657,11173904,38.0,6.2
Tender_1310,1934987,1576654,2012521,127416,255981,5907559,35.0,6.5
Tender_1311,765780,4070646,2758380,274901,438107,8307814,47.67,5.23
Tender_1312,4982513,4660767,1114367,369912,310242,11437801,45.33,5.47
Tender_1313,3094822,140101,1119635,897549,222822,5474929,24.33,7.57
Tender_1314,753611,3402213,1474178,50700,341245,6021947,35.67,6.43
Tender_1315,4392412,3268088,775138,307384,189407,8932429,39.67,6.03
Tender_1316,551728,2206537,2086579,781304,355138,5981286,54.33,4.57
Tender_1317,8131763,2694216,2718501,467664,164723,14176867,33.33,6.67
Tender_1318,3668762,4729639,1845665,97456,114730,10456252,47.0,5.3
Tender_1319,6053789,3161392,2847822,546700,482741,13092444,46.0,5.4
Tender_1320,4126275,3511315,2581012,748371,356244,11323217,36.0,6.4
Tender_1321,9626115,4149928,1780771,259201,307921,16123936,44.0,5.6
Tender_1322,6751927,4688386,1652682,725021,419623,14237639,41.0,5.9
Tender_1323,9074002,3261146,2923633,560339,198134,16017254,35.67,6.43
Tender_1324,2615014,4421576,819453,533377,179918,8569338,24.0,7.6
Tender_1325,8598826,1531559,2796647,132991,251096,13311119,44.67,5.53
Tender_1326,1298857,3440862,1323981,408687,130443,6602830,37.33,6.27
Tender_1327,5600252,4296594,679287,100130,311175,10987438,28.67,7.13
Tender_1328,8033403,3092249,2182258,458035,467549,14233494,46.0,5.4
Tender_1329,9198667,2750895,788483,127006,101330,12966381,42.67,5.73
Tender_1330,554962,1023975,898584,303956,489853,3271330,25.67,7.43
Tender_1331,357096,1336753,2098260,729924,184758,4706791,27.0,7.3
Tender_1332,8033923,4128513,1877099,604113,471420,15115068,51.67,4.83
Tender_1333,9616974,542874,1737422,102482,113452,12113204,37.33,6.27
Tender_1334,6644684,899535,968403,865264,380058,9757944,52.0,4.8
Tender_1335,2153431,965323,1932819,451867,498736,6002176,42.0,5.8
Tender_1336,7395342,4524577,2194438,333200,378381,14825938,55.67,4.43
Tender_1337,211291,1809407,2324975,675662,307327,5328662,22.33,7.77
Tender_1338,1241809,3632225,1095097,96832,141164,6207127,18.33,8.17
Tender_1339,8936244,569644,421865,103440,126688,10157881,48.33,5.17
Tender_1340,5528741,3417005,984150,841939,128429,10900264,37.33,6.27
Tender_1341,4316677,1998999,205549,241669,337242,7100136,39.0,6.1
Tender_1342,4572387,4267463,1848812,586886,176891,11452439,31.33,6.87
Tender_1343,8024063,200683,1816189,599593,60231,10700759,42.0,5.8
Tender_1344,5690630,2788450,2079865,709433,208063,11476441,34.33,6.57
Tender_1345,5479381,2925378,480486,51036,319639,9255920,22.67,7.73
Tender_1346,1219553,2682121,645008,566904,270126,5383712,48.0,5.2
Tender_1347,7561457,3096722,2705018,257021,290894,13911112,22.67,7.73
Tender_1348,5192100,3535462,904293,250151,454585,10336591,24.67,7.53
Tender_1349,9006249,2925286,2957750,617423,327573,15834281,28.33,7.17
Tender_1350,1868598,971784,2097282,289229,125863,5352756,34.33,6.57
Tender_1351,4537228,2904368,2280442,993309,324584,11039931,53.0,4.7
Tender_1352,5218864,2389338,1770111,961291,313305,10652909,46.33,5.37
Tender_1353,5328260,848870,2374523,792461,225616,9569730,35.0,6.5
Tender_1354,4175824,2434470,2416938,104799,159513,9291544,42.0,5.8
Tender_1355,4598269,1575686,1100705,345111,303779,7923550,39.67,6.03
Tender_1356,4909493,1950856,990161,100787,378980,8330277,53.33,4.67
Tender_1357,7090681,4613918,891962,355007,340780,13292348,53.33,4.67
Tender_1358,3020979,3606959,2406790,566775,180014,9781517,38.67,6.13
Tender_1359,6908976,737424,853411,686525,327174,9513510,26.67,7.33
Tender_1360,6891694,2666407,1846711,368513,382437,12155762,35.33,6.47
Tender_1361,3128494,2742811,1149089,824532,443921,8288847,41.67,5.83
Tender_1362,7146820,279979,2844062,142604,105742,10519207,39.0,6.1
Tender_1363,3835167,2657656,1543970,492479,456625,8985897,43.0,5.7
Tender_1364,5968275,1148176,2826419,166302,464759,10573931,26.67,7.33
Tender_1365,1806823,1985391,1355928,211553,206310,5566005,22.33,7.77
Tender_1366,8962826,4755745,2992566,288007,355103,17354247,51.33,4.87
Tender_1367,2004213,1527150,2329653,477347,413999,6752362,29.0,7.1
Tender_1368,4029289,1403777,684377,439826,259987,6817256,31.0,6.9
Tender_1369,9163430,3077685,1911475,221036,142202,14515828,44.33,5.57
Tender_1370,4112712,4417684,1076660,615848,175193,10398097,40.0,6.0
Tender_1371,3364378,639307,2701132,704713,378067,7787597,40.67,5.93
Tender_1372,4885856,2341989,2553028,257618,204743,10243234,48.33,5.17
Tender_1373,5304470,382728,1566733,848086,384069,8486086,28.33,7.17
Tender_1374,1532809,810942,1134197,692621,54965,4225534,27.33,7.27
Tender_1375,5549380,177015,2354486,253598,393142,8727621,35.0,6.5
Tender_1376,5856890,1014973,2856475,289096,441981,10459415,34.0,6.6
Tender_1377,3224625,1118147,2779271,943953,445639,8511635,34.0,6.6
Tender_1378,9827253,4941202,464152,870038,132734,16235379,33.0,6.7
Tender_1379,2870809,308538,1789775,750207,89592,5808921,37.67,6.23
Tender_1380,7953603,2988255,1717626,391845,249032,13300361,28.33,7.17
Tender_1381,7936840,391407,444423,566343,184577,9523590,29.33,7.07
Tender_1382,8101885,2639491,1214538,384477,421470,12761861,23.0,7.7
Tender_1383,7814576,2683502,2412480,829889,269042,14009489,29.33,7.07
Tender_1384,1693387,1531667,2225611,520097,460847,6431609,41.67,5.83
Tender_1385,3391237,4653085,2046391,317576,272485,10680774,23.33,7.67
Tender_1386,6399352,953604,2969590,991465,389069,11703080,42.33,5.77
Tender_1387,9148817,3620372,455681,357573,286365,13868808,51.0,4.9
Tender_1388,7105365,2658929,164224,437936,103223,10469677,50.33,4.97
Tender_1389,2169282,2761287,2210537,921864,370637,8433607,23.67,7.63
Tender_1390,6781369,4328152,732559,615666,180871,12638617,29.0,7.1
Tender_1391,591363,393198,2643107,219042,194826,4041536,33.33,6.67
Tender_1392,1180525,4527381,1866980,419294,394752,8388932,44.67,5.53
Tender_1393,1557163,1014437,2168494,733848,128568,5602510,49.67,5.03
Tender_1394,3639810,387923,2732061,727042,366806,7853642,27.33,7.27
Tender_1395,1951644,3429690,671713,525256,329001,6907304,29.33,7.07
Tender_1396,2155491,1999790,2646888,976934,268259,8047362,36.67,6.33
Tender_1397,4268493,2880948,583986,331274,116107,8180808,28.0,7.2
Tender_1398,8463879,3090762,1355609,229827,208245,13348322,43.33,5.67
Tender_1399,8614734,947706,2771238,284113,329076,12946867,42.0,5.8
Tender_1400,7663862,4956737,1509470,569781,119309,14819159,43.33,5.67
Tender_1401,1332449,4216988,2554881,879779,376661,9360758,40.0,6.0
Tender_1402,9275731,1301241,302594,523592,402731,11805889,35.33,6.47
Tender_1403,8111221,3445703,2513665,241021,144725,14456335,43.67,5.63
Tender_1404,7937917,1697090,1173968,82189,146330,11037494,43.33,5.67
Tender_1405,8999252,2546896,2019162,323182,347761,14236253,47.0,5.3
Tender_1406,9915253,2387958,673016,296000,486716,13758943,22.33,7.77
Tender_1407,2979281,3096764,501588,647688,484881,7710202,51.67,4.83
Tender_1408,9790249,2771126,1487248,278319,184599,14511541,32.67,6.73
Tender_1409,4251152,3591912,1492481,343631,168675,9847851,44.0,5.6
Tender_1410,1180349,3220154,1627554,395775,119130,6542962,31.0,6.9
Tender_1411,9834459,4728020,1044207,268811,135080,16010577,40.33,5.97
Tender_1412,1164918,1430581,640401,66749,413077,3715726,40.67,5.93
Tender_1413,7761221,2535690,2972606,285977,291923,13847417,35.33,6.47
Tender_1414,8118087,4244761,1465759,694733,449526,14972866,30.0,7.0
Tender_1415,2561791,3603717,669738,714557,107086,7656889,37.33,6.27
Tender_1416,5561157,4774187,1617808,437743,90678,12481573,33.67,6.63
Tender_1417,9498247,1241611,2187536,156707,217123,13301224,42.0,5.8
Tender_1418,5213019,2752982,2918196,656051,117418,11657666,40.67,5.93
Tender_1419,1016097,4583396,2150513,341752,158790,8250548,34.33,6.57
Tender_1420,1069207,2224841,2206036,459569,430892,6390545,33.67,6.63
Tender_1421,289689,3095141,1583595,613353,231907,5813685,46.33,5.37
Tender_1422,7156579,4284488,2766942,545631,430862,15184502,21.33,7.87
Tender_1423,3336971,1215647,2190517,599220,307100,7649455,40.0,6.0
Tender_1424,5756214,1350092,595665,989721,322051,9013743,25.33,7.47
Tender_1425,635385,502239,318550,535544,87073,2078791,15.67,8.43
Tender_1426,4761479,3208250,646836,771847,199285,9587697,47.0,5.3
Tender_1427,7050198,464437,2806812,168614,339614,10829675,38.0,6.2
Tender_1428,6645514,1115610,1260985,302315,109387,9433811,28.0,7.2
Tender_1429,6824140,819919,299404,696313,494598,9134374,38.67,6.13
Tender_1430,262756,3316716,650943,417262,337488,4985165,36.0,6.4
Tender_1431,5808268,281793,942318,79944,82072,7194395,45.67,5.43
Tender_1432,231315,288080,2151766,305346,144231,3120738,29.67,7.03
Tender_1433,7183969,1274108,531181,761158,465714,10216130,36.67,6.33
Tender_1434,8872148,3689347,1099304,971340,69427,14701566,38.33,6.17
Tender_1435,9713591,4448601,142842,760892,242924,15308850,49.0,5.1
Tender_1436,641328,2631294,2837602,597341,414710,7122275,23.0,7.7
Tender_1437,3263350,3760435,1098993,433899,197562,8754239,38.0,6.2
Tender_1438,6296404,4090668,2644591,330886,452712,13815261,27.67,7.23
Tender_1439,6401396,3944453,247825,271899,56503,10922076,42.0,5.8
Tender_1440,2824423,4245326,2551982,255460,225890,10103081,37.0,6.3
Tender_1441,8681554,3732155,2294743,494496,320100,15523048,40.0,6.0
Tender_1442,8939008,1117978,2002227,462328,118347,12639888,52.0,4.8
Tender_1443,7836079,4999713,1035063,421496,309545,14601896,38.0,6.2
Tender_1444,3515342,1582820,411622,938512,403231,6851527,49.33,5.07
Tender_1445,7918627,499616,1003566,591984,372809,10386602,49.33,5.07
Tender_1446,9573409,1212662,897676,720218,372660,12776625,52.0,4.8
Tender_1447,4617893,4957340,502126,810143,84931,10972433,29.0,7.1
Tender_1448,628755,4008747,2832091,125481,197176,7792250,33.0,6.7
Tender_1449,7614298,3470292,696409,689580,57051,12527630,37.33,6.27
Tender_1450,385477,2177516,2861966,798134,186865,6409958,41.33,5.87
Tender_1451,4613891,3787021,1456848,308101,109588,10275449,45.0,5.5
Tender_1452,2130092,3844726,1787025,229544,434274,8425661,30.33,6.97
Tender_1453,9956017,2964014,2999065,829647,340678,17089421,31.33,6.87
Tender_1454,649972,3012297,2368684,51226,410344,6492523,49.67,5.03
Tender_1455,3108459,3130640,65271,683751,267068,7255189,29.33,7.07
Tender_1456,4700248,3814663,2514162,458576,413848,11901497,40.33,5.97
Tender_1457,2224308,2592829,1663018,503527,357514,7341196,47.0,5.3
Tender_1458,7083873,2048053,1058337,525997,80275,10796535,36.0,6.4
Tender_1459,1947202,969844,2798260,982716,232584,6930606,41.33,5.87
Tender_1460,8518436,1689128,1116021,728797,261891,12314273,36.67,6.33
Tender_1461,7712655,3312367,2157298,239272,474346,13895938,54.33,4.57
Tender_1462,2493182,3305099,2587453,154058,175217,8715009,40.67,5.93
Tender_1463,3401778,3829469,1042846,495523,313009,9082625,41.67,5.83
Tender_1464,8561522,873092,1793155,228433,58479,11514681,29.33,7.07
Tender_1465,9764428,868343,1478413,377726,205403,12694313,47.0,5.3
Tender_1466,7589041,3457727,2466059,762223,66238,14341288,44.67,5.53
Tender_1467,4043400,1477884,1275949,500573,59365,7357171,46.33,5.37
Tender_1468,739734,3105197,1613876,628638,210091,6297536,42.0,5.8
Tender_1469,9733076,1801452,2680635,406798,240664,14862625,40.0,6.0
Tender_1470,449816,2912591,2990762,518657,241431,7113257,55.0,4.5
Tender_1471,5713738,1601081,2855259,613299,145026,10928403,26.67,7.33
Tender_1472,3963817,1234293,1513333,611151,485474,7808068,42.0,5.8
Tender_1473,3466406,2005042,2022497,320055,246344,8060344,50.0,5.0
Tender_1474,1140574,4787519,59053,271019,128173,6386338,37.0,6.3
Tender_1475,2144375,3436930,385998,363127,264664,6595094,52.0,4.8
Tender_1476,2887651,1499953,2829050,529739,214182,7960575,52.67,4.73
Tender_1477,5731625,4918515,1985891,394592,195862,13226485,35.33,6.47
Tender_1478,2285674,782981,746277,637082,254660,4706674,41.33,5.87
Tender_1479,9039217,4599419,2028596,420584,79346,16167162,50.33,4.97
Tender_1480,7372725,4095747,2187711,57706,261490,13975379,31.0,6.9
Tender_1481,4934856,1785548,1531280,624809,306722,9183215,29.67,7.03
Tender_1482,7717924,4016916,938622,998047,366804,14038313,25.67,7.43
Tender_1483,528130,2951896,2458379,101210,143498,6183113,41.33,5.87
Tender_1484,4534804,2194938,2267991,583514,264017,9845264,35.33,6.47
Tender_1485,9062295,3908847,2001759,737257,313750,16023908,24.33,7.57
Tender_1486,6453096,1199862,1148555,499860,337080,9638453,43.33,5.67
Tender_1487,5526840,4111542,1466519,117054,316484,11538439,23.0,7.7
Tender_1488,967753,3072588,2959211,90539,171347,7261438,47.33,5.27
Tender_1489,3061727,928626,2137887,377776,180530,6686546,38.33,6.17
Tender_1490,3625186,1917468,940465,754293,205059,7442471,35.33,6.47
Tender_1491,1582121,752508,1858208,539397,418379,5150613,35.0,6.5
Tender_1492,4368251,2843866,1168727,208827,246034,8835705,25.33,7.47
Tender_1493,7746440,4463244,556080,485651,326032,13577447,37.33,6.27
Tender_1494,5128347,3281830,1103274,735861,54821,10304133,57.0,4.3
Tender_1495,4741451,1296892,2570740,780468,350383,9739934,30.0,7.0
Tender_1496,8395585,294898,632081,392554,276995,9992113,40.0,6.0
Tender_1497,2217628,4057653,2290814,912371,426513,9904979,27.0,7.3
Tender_1498,5979930,707328,1742326,990212,373243,9793039,35.0,6.5
Tender_1499,6547458,1824098,1230769,993524,265368,10861217,36.0,6.4
Tender_1500,6208992,4498390,2822000,202676,175986,13908044,38.33,6.17
Tender_1501,1068684,4896536,68452,578377,50051,6662100,29.67,7.03
Tender_1502,3861552,2213200,535341,996498,351046,7957637,27.33,7.27
Tender_1503,8142707,4092802,2394720,764891,215603,15610723,43.0,5.7
Tender_1504,1862440,4008461,388422,967307,442808,7669438,39.33,6.07
Tender_1505,5626952,4746376,120242,819723,260064,11573357,33.33,6.67
Tender_1506,720374,2919005,390065,318883,492356,4840683,36.67,6.33
Tender_1507,379002,2611981,2808466,464300,298202,6561951,27.0,7.3
Tender_1508,8323697,534549,742967,792664,239706,10633583,45.33,5.47
Tender_1509,4505898,3824343,2496774,133535,218440,11178990,51.67,4.83
Tender_1510,9507006,2282239,164469,390970,77157,12421841,40.67,5.93
Tender_1511,8838925,2999366,252312,661172,393907,13145682,40.33,5.97
Tender_1512,3917861,2164561,826122,464845,155449,7528838,37.33,6.27
Tender_1513,8767196,1879776,2881572,386343,282086,14196973,41.67,5.83
Tender_1514,2699185,2395023,397162,365270,466949,6323589,37.0,6.3
Tender_1515,7518057,810924,166609,288806,260252,9044648,31.33,6.87
Tender_1516,9224731,966024,1916059,652555,395873,13155242,34.67,6.53
Tender_1517,2628249,1649513,2432310,175859,472453,7358384,58.0,4.2
Tender_1518,1126499,1931320,1798897,825499,208779,5890994,41.67,5.83
Tender_1519,1573778,3522447,2788692,71876,437092,8393885,47.0,5.3
Tender_1520,2600471,2614673,1072485,420232,304206,7012067,33.0,6.7
Tender_1521,777593,3510293,1629815,136126,319277,6373104,23.0,7.7
Tender_1522,2623613,1618822,1696247,52571,354377,6345630,43.0,5.7
Tender_1523,2004099,4656711,2597686,499656,109662,9867814,46.33,5.37
Tender_1524,5547039,2819735,54926,432971,169566,9024237,32.33,6.77
Tender_1525,2603852,511056,610819,486751,172001,4384479,43.33,5.67
Tender_1526,6986847,3248005,67268,958056,371369,11631545,29.33,7.07
Tender_1527,3111408,4909833,1453809,729491,57703,10262244,40.67,5.93
Tender_1528,1005447,3447625,449193,591653,53872,5547790,32.0,6.8
Tender_1529,8316213,3927449,107012,615643,301141,13267458,52.67,4.73
Tender_1530,7339382,1406214,2572520,447145,207497,11972758,35.0,6.5
Tender_1531,8115850,151468,2697501,710322,278321,11953462,40.33,5.97
Tender_1532,9806073,3432451,872158,510674,135009,14756365,52.33,4.77
Tender_1533,6322688,2329191,824206,307168,321284,10104537,31.67,6.83
Tender_1534,8460937,3963622,2266944,597196,260950,15549649,47.33,5.27
Tender_1535,5451879,2680461,734968,968173,349399,10184880,26.33,7.37
Tender_1536,7958616,145206,486405,934620,105115,9629962,44.67,5.53
Tender_1537,1944480,2956408,792255,863902,114097,6671142,35.67,6.43
Tender_1538,8681883,3208464,1539510,878766,78906,14387529,46.0,5.4
Tender_1539,7469081,235383,609860,714549,223681,9252554,37.0,6.3
Tender_1540,7724656,1976454,2400115,194887,52278,12348390,48.67,5.13
Tender_1541,2560341,4091034,1509177,225584,268262,8654398,38.0,6.2
Tender_1542,6363659,2747605,1553978,455162,387794,11508198,35.67,6.43
Tender_1543,463636,204017,808525,399411,434507,2310096,63.0,3.7
Tender_1544,655046,1140670,159999,423577,331272,2710564,22.0,7.8
Tender_1545,7518637,3533761,593626,752207,162544,12560775,35.0,6.5
Tender_1546,8022244,100586,2510832,886298,241843,11761803,39.67,6.03
Tender_1547,4305239,2808746,2147523,859239,312547,10433294,26.67,7.33
Tender_1548,7310421,3156887,360131,642020,412244,11881703,27.0,7.3
Tender_1549,5949973,4204410,958152,673429,299917,12085881,41.33,5.87
Tender_1550,8835276,463917,1456181,889212,309292,11953878,44.67,5.53
Tender_1551,7721080,2428865,607280,745867,251657,11754749,36.33,6.37
Tender_1552,9977770,4130060,2368703,799363,257507,17533403,45.33,5.47
Tender_1553,4578315,4364290,2781303,851309,151492,12726709,39.0,6.1
Tender_1554,2683192,3839900,1096087,688469,105629,8413277,39.0,6.1
Tender_1555,3732408,628610,1081612,998921,278791,6720342,42.0,5.8
Tender_1556,2203935,1212198,2226253,270799,88732,6001917,24.67,7.53
Tender_1557,6015728,2047557,2277027,270449,394457,11005218,29.67,7.03
Tender_1558,2018469,4123296,621700,913624,369138,8046227,40.0,6.0
Tender_1559,2047083,1579521,2325156,160840,339338,6451938,29.67,7.03
Tender_1560,334024,4763162,1463871,929264,410571,7900892,44.0,5.6
Tender_1561,9557381,4033333,1386921,189778,279344,15446757,38.0,6.2
Tender_1562,1515738,2090144,2881596,692434,181874,7361786,31.0,6.9
Tender_1563,8479271,3133618,2772339,728467,389120,15502815,39.0,6.1
Tender_1564,8799412,4201914,2085929,703558,76871,15867684,29.0,7.1
Tender_1565,3521226,3459060,2405665,941904,245249,10573104,44.0,5.6
Tender_1566,1514165,4450535,1812653,308062,496523,8581938,34.0,6.6
Tender_1567,4027058,3101185,2053792,176581,180429,9539045,17.0,8.3
Tender_1568,5735964,3739373,2637197,983117,306517,13402168,47.67,5.23
Tender_1569,7893233,2224176,1674686,875170,270979,12938244,45.0,5.5
Tender_1570,1390075,1371206,891415,823291,281778,4757765,31.0,6.9
Tender_1571,1186192,3566776,278245,422892,67591,5521696,35.0,6.5
Tender_1572,3506896,3015448,718684,236971,412886,7890885,39.0,6.1
Tender_1573,7076130,1878553,1016587,306566,183523,10461359,44.33,5.57
Tender_1574,7335215,4962780,1535115,841592,93374,14768076,29.33,7.07
Tender_1575,2053062,615339,2471066,962693,217806,6319966,35.67,6.43
Tender_1576,8319302,2723415,2228635,59359,110032,13440743,43.67,5.63
Tender_1577,7070336,2481573,2243843,740970,55249,12591971,36.67,6.33
Tender_1578,6248166,4054823,2894570,72660,258978,13529197,32.67,6.73
Tender_1579,8707707,784692,1716097,403130,96840,11708466,48.33,5.17
Tender_1580,8710308,4266381,56583,137940,142725,13313937,51.0,4.9
Tender_1581,1639020,3778428,289436,495248,455492,6657624,32.67,6.73
Tender_1582,9021855,2229553,279839,877679,478411,12887337,43.0,5.7
Tender_1583,8757633,907172,71990,480276,392465,10609536,29.67,7.03
Tender_1584,4225625,3645978,130777,713923,409972,9126275,28.67,7.13
Tender_1585,8007795,4513742,1224617,421255,225620,14393029,56.0,4.4
Tender_1586,6536655,3643917,2837746,201067,125077,13344462,25.33,7.47
Tender_1587,560521,4193378,1700799,907070,82441,7444209,24.33,7.57
Tender_1588,7262439,2471722,2214528,268731,261819,12479239,44.67,5.53
Tender_1589,1335762,2430023,899050,360537,82308,5107680,23.33,7.67
Tender_1590,7760977,4508068,1556504,897160,213983,14936692,43.33,5.67
Tender_1591,1498075,4840438,653874,294360,285351,7572098,45.33,5.47
Tender_1592,2418861,3408989,1324135,121091,362492,7635568,31.0,6.9
Tender_1593,6162003,1098180,447584,647718,364605,8720090,45.67,5.43
Tender_1594,5926190,2920352,2751686,338721,167185,12104134,40.0,6.0
Tender_1595,1128161,964882,1473273,445437,191942,4203695,41.0,5.9
Tender_1596,7762252,3726054,279863,406153,478505,12652827,44.67,5.53
Tender_1597,5974724,219111,1966275,828779,420379,9409268,28.33,7.17
Tender_1598,9273778,245672,1807352,527266,115320,11969388,29.0,7.1
Tender_1599,4656347,4768621,1556194,356291,413896,11751349,38.33,6.17
Tender_1600,9824874,198646,715906,994485,142737,11876648,50.33,4.97
Tender_1601,3483671,2236630,2975691,701665,83516,9481173,50.0,5.0
Tender_1602,2157879,2483835,940951,694920,416971,6694556,45.67,5.43
Tender_1603,8230630,1808362,894969,920389,481620,12335970,49.0,5.1
Tender_1604,9185978,3151114,1377449,797512,203689,14715742,45.67,5.43
Tender_1605,2877087,4593662,2076414,592138,313553,10452854,45.0,5.5
Tender_1606,7229838,2013091,244017,120936,436380,10044262,32.33,6.77
Tender_1607,4663397,2980361,519029,489830,333623,8986240,31.0,6.9
Tender_1608,1178121,989519,2482744,908704,216972,5776060,38.67,6.13
Tender_1609,9375259,115812,478154,355305,95831,10420361,35.0,6.5
Tender_1610,3508825,496274,1807206,768704,191721,6772730,54.0,4.6
Tender_1611,4725107,3596494,1391716,582814,227965,10524096,51.67,4.83
Tender_1612,4783540,4052460,246832,368744,480481,9932057,44.33,5.57
Tender_1613,5348578,380297,2413230,916986,306099,9365190,54.67,4.53
Tender_1614,3675004,3845755,625127,921884,416137,9483907,40.0,6.0
Tender_1615,4806751,3720994,2561782,921805,348392,12359724,27.0,7.3
Tender_1616,1230579,305380,2233416,464284,220432,4454091,30.0,7.0
Tender_1617,3271717,2166445,2927740,245490,260738,8872130,37.0,6.3
Tender_1618,8881706,2325779,276605,332141,73784,11890015,40.33,5.97
Tender_1619,8956612,3172991,1743930,830926,230831,14935290,39.33,6.07
Tender_1620,5818466,1963110,2966766,980138,270526,11999006,57.33,4.27
Tender_1621,5447713,263109,1510075,280390,451499,7952786,33.33,6.67
Tender_1622,1624447,364362,461952,786279,67138,3304178,26.67,7.33
Tender_1623,1147343,3942675,1520028,892688,301417,7804151,34.67,6.53
Tender_1624,8776867,1687958,609969,174412,176669,11425875,52.67,4.73
Tender_1625,7862287,2455404,1929970,358394,294729,12900784,40.33,5.97
Tender_1626,7792370,835250,185511,973088,280345,10066564,38.0,6.2
Tender_1627,2016240,3116907,445054,259273,93891,5931365,32.67,6.73
Tender_1628,8395875,1400218,2800152,397707,449441,13443393,44.0,5.6
Tender_1629,5464843,4125495,688257,506064,112796,10897455,42.0,5.8
Tender_1630,7526795,2417354,2971266,64800,315722,13295937,36.67,6.33
Tender_1631,6540256,1390524,2079277,301801,332788,10644646,33.0,6.7
Tender_1632,4343953,812914,1207784,314370,144629,6823650,38.33,6.17
Tender_1633,5458772,1286446,55119,128549,388885,7317771,31.33,6.87
Tender_1634,8418260,4608178,529634,123238,182152,13861462,39.67,6.03
Tender_1635,9961524,1118665,657689,994925,135126,12867929,45.0,5.5
Tender_1636,216769,2161505,2544414,337360,64703,5324751,28.33,7.17
Tender_1637,3466086,1784530,1831261,500536,494597,8077010,27.67,7.23
Tender_1638,8715317,596207,2735078,240595,216920,12504117,32.67,6.73
Tender_1639,1349738,2582490,2010383,419653,472755,6835019,23.33,7.67
Tender_1640,9242361,2121791,1801644,966308,114178,14246282,36.0,6.4
Tender_1641,7315297,4509593,1165900,978433,144482,14113705,25.33,7.47
Tender_1642,8920968,559499,613247,651115,246276,10991105,37.67,6.23
Tender_1643,3587091,1104671,1165889,892224,421014,7170889,38.33,6.17
Tender_1644,2909865,4702321,2559911,962839,173487,11308423,30.67,6.93
Tender_1645,1223378,560407,1379022,921177,135097,4219081,42.33,5.77
Tender_1646,360061,4631269,1310250,398558,122104,6822242,31.67,6.83
Tender_1647,8046515,4223087,2112576,837985,54578,15274741,23.67,7.63
Tender_1648,3620424,3051047,1781788,342221,260126,9055606,31.33,6.87
Tender_1649,9486947,1684529,2117647,156798,385124,13831045,28.0,7.2
Tender_1650,6790409,3907905,405379,205973,109366,11419032,30.0,7.0
Tender_1651,5718634,2593802,2501660,876073,352595,12042764,18.67,8.13
Tender_1652,5063146,996103,683832,575474,182271,7500826,55.67,4.43
Tender_1653,4114713,1559783,626372,77982,407628,6786478,49.33,5.07
Tender_1654,7664509,3604386,1305606,757511,436867,13768879,36.33,6.37
Tender_1655,256059,249437,1954292,682046,105693,3247527,32.33,6.77
Tender_1656,1970768,306093,2317955,339224,284353,5218393,41.0,5.9
Tender_1657,2255631,1454143,683372,884443,171612,5449201,29.67,7.03
Tender_1658,2417788,3653313,744580,691453,299608,7806742,36.33,6.37
Tender_1659,6804391,3785812,547452,256232,444835,11838722,25.67,7.43
Tender_1660,3198467,2335459,2864805,58256,426065,8883052,54.67,4.53
Tender_1661,9008667,2973151,1036931,406329,104728,13529806,51.0,4.9
Tender_1662,7901180,4402952,2926769,758816,200190,16189907,28.0,7.2
Tender_1663,2488346,3337570,635090,839569,391609,7692184,41.67,5.83
Tender_1664,2438377,717541,1502452,385078,184095,5227543,31.33,6.87
Tender_1665,4598595,4479810,2336452,272626,410721,12098204,44.0,5.6
Tender_1666,9798144,4879824,2239946,339771,146979,17404664,40.67,5.93
Tender_1667,7666847,2261010,155269,114095,109572,10306793,44.0,5.6
Tender_1668,7036389,1196507,2144705,731362,201358,11310321,36.67,6.33
Tender_1669,1711430,346800,1747171,81465,486913,4373779,52.33,4.77
Tender_1670,3875835,3313287,453413,671989,61805,8376329,38.33,6.17
Tender_1671,5405863,1362451,2905065,370182,132006,10175567,49.33,5.07
Tender_1672,9174992,2569757,584768,482101,71790,12883408,24.33,7.57
Tender_1673,8495292,4596450,2510079,525952,361561,16489334,53.67,4.63
Tender_1674,8156695,4585635,594582,349389,138983,13825284,40.67,5.93
Tender_1675,6601735,3933287,2054354,601426,83571,13274373,41.33,5.87
Tender_1676,931978,4311626,53312,66618,416530,5780064,41.67,5.83
Tender_1677,1821641,1189360,1851845,337962,80688,5281496,31.0,6.9
Tender_1678,3921674,359219,2838382,161535,432718,7713528,26.0,7.4
Tender_1679,1908927,1449142,1621474,142557,117946,5240046,48.0,5.2
Tender_1680,573659,4807814,993320,367669,388990,7131452,22.0,7.8
Tender_1681,9146220,1301165,2757473,383936,428336,14017130,46.0,5.4
Tender_1682,7376197,3025076,1661914,528877,312834,12904898,29.0,7.1
Tender_1683,2408436,1735413,1711283,436071,179150,6470353,47.33,5.27
Tender_1684,4580010,3702710,491632,901311,424543,10100206,48.0,5.2
Tender_1685,6299824,3016931,665509,272828,186218,10441310,41.0,5.9
Tender_1686,3510419,2767200,2984056,282599,318977,9863251,32.33,6.77
Tender_1687,1531049,1352440,401263,671212,270529,4226493,32.0,6.8
Tender_1688,2268495,1400560,532856,396080,148566,4746557,38.67,6.13
Tender_1689,5468574,282568,624168,755809,410345,7541464,45.33,5.47
Tender_1690,8461831,2730913,956654,117906,499823,12767127,40.33,5.97
Tender_1691,1982060,1688995,1988043,424662,408929,6492689,36.0,6.4
Tender_1692,9343375,4615442,2561254,722048,245208,17487327,39.33,6.07
Tender_1693,2537306,2508367,690020,527126,216548,6479367,40.33,5.97
Tender_1694,6751840,4493969,2158464,332877,281542,14018692,39.0,6.1
Tender_1695,5830508,621344,427578,861173,484106,8224709,52.33,4.77
Tender_1696,2455755,2059928,1162857,498583,406606,6583729,27.67,7.23
Tender_1697,3225767,169388,2939103,67389,459300,6860947,32.33,6.77
Tender_1698,7850199,1560186,2241658,486012,389966,12528021,35.67,6.43
Tender_1699,2161905,3059429,249563,915236,308451,6694584,51.0,4.9
Tender_1700,356558,959014,701036,536546,440856,2994010,48.67,5.13
Tender_1701,6952090,2986615,738782,979871,214738,11872096,53.0,4.7
Tender_1702,9093855,4009560,2666152,576626,186285,16532478,49.33,5.07
Tender_1703,4560284,1069487,2200792,77072,148723,8056358,35.67,6.43
Tender_1704,7065252,3384360,875733,942684,378628,12646657,38.67,6.13
Tender_1705,7299466,626410,1459320,617959,287846,10291001,52.67,4.73
Tender_1706,7519318,2944543,2200839,250013,144091,13058804,49.0,5.1
Tender_1707,6195167,2597181,1998057,147780,362571,11300756,29.67,7.03
Tender_1708,7203747,3540302,1155971,244057,421559,12565636,53.33,4.67
Tender_1709,6343410,3934882,1956720,319068,217059,12771139,25.33,7.47
Tender_1710,9288801,1369990,1296456,505428,201583,12662258,31.0,6.9
Tender_1711,4397391,1690610,1173501,920620,83591,8265713,38.67,6.13
Tender_1712,745305,226421,565486,736522,424888,2698622,30.67,6.93
Tender_1713,4955702,2522170,2799524,424858,396401,11098655,33.67,6.63
Tender_1714,3280635,2649521,583560,257474,136736,6907926,43.67,5.63
Tender_1715,9918749,991618,1265039,825112,464544,13465062,49.67,5.03
Tender_1716,1607193,4684269,116298,53543,219497,6680800,40.33,5.97
Tender_1717,1242987,3179305,1224094,560337,427366,6634089,44.33,5.57
Tender_1718,3807494,412469,1083298,806424,142046,6251731,46.67,5.33
Tender_1719,7624384,3826348,2280160,877113,100932,14708937,42.0,5.8
Tender_1720,4679994,687281,1136251,211418,440612,7155556,45.33,5.47
Tender_1721,9982793,749841,833897,827015,92140,12485686,31.0,6.9
Tender_1722,7770478,1839967,2263375,914161,436007,13223988,35.33,6.47
Tender_1723,3447575,4318858,2211936,233197,112453,10324019,29.67,7.03
Tender_1724,7318673,1775659,1034007,664982,468970,11262291,46.33,5.37
Tender_1725,5223091,2992517,1055355,839679,438177,10548819,56.33,4.37
Tender_1726,6292168,660029,1514190,648429,414448,9529264,39.67,6.03
Tender_1727,7162714,2283063,2842576,973866,257449,13519668,24.67,7.53
Tender_1728,8516823,3758545,376423,430418,355570,13437779,34.0,6.6
Tender_1729,1436084,2170169,389859,401910,479286,4877308,36.33,6.37
Tender_1730,2877409,3127181,1527681,203256,280706,8016233,45.0,5.5
Tender_1731,1520323,2537791,2325986,122064,425060,6931224,46.67,5.33
Tender_1732,2914568,3967290,2797924,379510,149565,10208857,33.67,6.63
Tender_1733,5223047,3453008,767263,517671,257390,10218379,39.33,6.07
Tender_1734,9465686,3183594,2044534,230065,260049,15183928,20.0,8.0
Tender_1735,7678399,4595064,86635,793929,244152,13398179,29.67,7.03
Tender_1736,7457604,2424836,708293,294425,192729,11077887,39.67,6.03
Tender_1737,5247028,4602864,1120123,153695,51853,11175563,37.0,6.3
Tender_1738,1454474,4750199,2691103,321192,439989,9656957,44.33,5.57
Tender_1739,5593921,2807757,2998371,635085,441582,12476716,32.0,6.8
Tender_1740,6101566,2607054,1568636,627225,386465,11290946,30.0,7.0
Tender_1741,8155695,3942868,743330,658840,325336,13826069,49.33,5.07
Tender_1742,2484663,3531541,2239399,514515,67496,8837614,54.67,4.53
Tender_1743,2233522,1594821,1597022,710741,72473,6208579,37.67,6.23
Tender_1744,4361346,115829,2413528,403614,195990,7490307,33.0,6.7
Tender_1745,1296549,3670448,783640,432818,153387,6336842,42.67,5.73
Tender_1746,1592808,4859153,972181,949968,318365,8692475,43.33,5.67
Tender_1747,4353273,2040014,1263124,433936,256934,8347281,46.0,5.4
Tender_1748,9975313,2480426,1237419,647030,451484,14791672,46.33,5.37
Tender_1749,6550195,4381110,1814622,485246,223174,13454347,54.33,4.57
Tender_1750,9015947,3372765,1008465,580818,146135,14124130,43.33,5.67
Tender_1751,4255742,4163248,946349,323249,263602,9952190,28.0,7.2
Tender_1752,1002809,1877751,769603,173469,497567,4321199,45.67,5.43
Tender_1753,3032340,3922076,431839,248030,323959,7958244,50.67,4.93
Tender_1754,8617090,242499,364208,630968,199895,10054660,28.33,7.17
Tender_1755,2881473,1652116,364199,645460,94471,5637719,34.0,6.6
Tender_1756,9876402,1010893,2638137,802502,338848,14666782,41.67,5.83
Tender_1757,7769809,4105034,1113538,186156,440629,13615166,28.67,7.13
Tender_1758,7464884,3388897,2068969,944961,436385,14304096,52.33,4.77
Tender_1759,8349359,1112576,188573,602162,275301,10527971,34.67,6.53
Tender_1760,3160300,4114055,333177,623533,428537,8659602,28.67,7.13
Tender_1761,3198238,2278880,346665,632902,64378,6521063,41.67,5.83
Tender_1762,474390,1781166,2125646,538090,216069,5135361,38.33,6.17
Tender_1763,8510274,1261308,670716,401900,155568,10999766,48.33,5.17
Tender_1764,1613418,3631087,2806312,453746,373436,8877999,32.33,6.77
Tender_1765,1487684,2644954,1047679,995406,70885,6246608,25.0,7.5
Tender_1766,3813125,802283,2434841,670770,73769,7794788,51.0,4.9
Tender_1767,6339576,4131995,1652257,789680,376430,13289938,49.67,5.03
Tender_1768,664940,1440076,984018,691945,50945,3831924,36.33,6.37
Tender_1769,4016971,1654253,2725817,689839,481471,9568351,30.33,6.97
Tender_1770,3369392,3120402,407119,65427,238989,7201329,30.67,6.93
Tender_1771,7024940,3140381,2528479,998957,344848,14037605,44.67,5.53
Tender_1772,7124056,1106096,2784224,631581,446063,12092020,36.33,6.37
Tender_1773,8913283,2556040,119843,823466,195125,12607757,24.67,7.53
Tender_1774,5021345,3032693,2905128,851196,324885,12135247,40.33,5.97
Tender_1775,5032165,4742971,2851686,378706,451818,13457346,30.33,6.97
Tender_1776,2561637,4364020,492856,860814,98464,8377791,38.33,6.17
Tender_1777,8497661,2853087,2962276,882862,178056,15373942,45.0,5.5
Tender_1778,9604203,286910,2962340,793268,266088,13912809,47.0,5.3
Tender_1779,3648954,1142213,2725073,461441,407203,8384884,45.0,5.5
Tender_1780,7353613,4651715,226761,681671,444971,13358731,20.0,8.0
Tender_1781,8179774,1622255,1971443,924784,387806,13086062,33.67,6.63
Tender_1782,8274770,4883450,2703913,967528,360576,17190237,38.0,6.2
Tender_1783,4883248,229510,1872718,976637,499748,8461861,42.33,5.77
Tender_1784,5172346,878314,690592,183700,231163,7156115,41.0,5.9
Tender_1785,8426736,183057,1033804,103097,269218,10015912,50.33,4.97
Tender_1786,3346231,1015163,2112612,211112,452837,7137955,28.67,7.13
Tender_1787,3038875,570261,2171208,608250,216203,6604797,40.33,5.97
Tender_1788,5063421,1531421,1618875,718967,267084,9199768,37.0,6.3
Tender_1789,5765835,3274731,1500069,851133,230092,11621860,42.33,5.77
Tender_1790,7775740,2158101,1837648,253724,264749,12289962,39.67,6.03
Tender_1791,2118089,4988749,1984908,409483,257779,9759008,25.33,7.47
Tender_1792,9801429,431234,511167,190089,257432,11191351,37.67,6.23
Tender_1793,5739953,209198,767300,852566,175491,7744508,52.67,4.73
Tender_1794,6333626,956949,961420,582478,153943,8988416,30.33,6.97
Tender_1795,4751524,4986665,2783521,522368,73653,13117731,44.33,5.57
Tender_1796,9689786,352811,2710536,445336,411975,13610444,41.0,5.9
Tender_1797,7500889,3859827,242995,905130,339790,12848631,27.0,7.3
Tender_1798,9260732,2054562,368621,748551,54935,12487401,41.67,5.83
Tender_1799,4445382,4860053,1877210,554114,135905,11872664,50.67,4.93
Tender_1800,8179548,2383000,2138048,863831,223962,13788389,45.67,5.43
Tender_1801,2839446,4805701,1336664,394858,183856,9560525,45.0,5.5
Tender_1802,7860759,4771092,995431,449607,162542,14239431,45.0,5.5
Tender_1803,6942231,2173144,191161,503540,295613,10105689,40.67,5.93
Tender_1804,912675,2660676,692905,544972,158961,4970189,36.0,6.4
Tender_1805,4571163,103177,485778,277216,103452,5540786,28.33,7.17
Tender_1806,1358182,1881824,585687,729620,255195,4810508,47.67,5.23
Tender_1807,3120146,405461,170069,156051,285219,4136946,52.33,4.77
Tender_1808,9317665,3652133,1878340,437824,270011,15555973,34.67,6.53
Tender_1809,1756423,107239,1743629,711619,369864,4688774,38.0,6.2
Tender_1810,8222132,3896887,1036323,895385,312774,14363501,54.67,4.53
Tender_1811,8587110,4084287,763917,619684,292141,14347139,41.67,5.83
Tender_1812,2051729,650555,1884356,811810,214472,5612922,34.0,6.6
Tender_1813,8354446,4572159,1945481,331753,115489,15319328,48.0,5.2
Tender_1814,1712491,3973314,1030209,180834,437628,7334476,38.0,6.2
Tender_1815,6662842,1576416,2513147,538723,405135,11696263,47.33,5.27
Tender_1816,5008970,4178903,1610479,154525,423022,11375899,29.0,7.1
Tender_1817,4758160,500011,2233737,936199,457708,8885815,27.33,7.27
Tender_1818,5400487,1689649,2661888,337587,450562,10540173,61.33,3.87
Tender_1819,3308490,2279518,1256435,886538,212494,7943475,38.33,6.17
Tender_1820,9611883,2737444,2203257,537261,431374,15521219,26.67,7.33
Tender_1821,3356767,561276,1075902,694021,258453,5946419,30.67,6.93
Tender_1822,9973820,3224552,695433,901236,187572,14982613,36.67,6.33
Tender_1823,6550490,4674182,2231518,449721,257521,14163432,34.0,6.6
Tender_1824,3776687,4326926,2967675,634257,62044,11767589,36.0,6.4
Tender_1825,3112467,1521296,1625346,386300,416204,7061613,57.67,4.23
Tender_1826,4764894,463567,1296431,134778,496269,7155939,34.67,6.53
Tender_1827,8471666,1538120,2946651,676885,257017,13890339,39.0,6.1
Tender_1828,872960,2198851,1777217,978339,147177,5974544,33.33,6.67
Tender_1829,386289,2215241,1185403,817361,215303,4819597,43.33,5.67
Tender_1830,5405607,3453676,574077,796004,423979,10653343,47.33,5.27
Tender_1831,3010908,2484600,575405,674831,402073,7147817,37.0,6.3
Tender_1832,6432482,1840762,1680440,58188,87369,10099241,42.0,5.8
Tender_1833,5605778,4052141,1817785,538462,66505,12080671,47.0,5.3
Tender_1834,4748806,2536994,1091040,467058,190838,9034736,53.33,4.67
Tender_1835,8075354,1615396,167051,796001,336649,10990451,22.33,7.77
Tender_1836,2135851,1348517,1466186,428350,141684,5520588,40.67,5.93
Tender_1837,2971969,2821073,2524923,175718,448232,8941915,44.0,5.6
Tender_1838,1032974,4213535,1777557,442592,314329,7780987,47.0,5.3
Tender_1839,811016,4224997,2171545,988751,77846,8274155,31.0,6.9
Tender_1840,7598616,4382898,2750523,198742,88884,15019663,40.33,5.97
Tender_1841,4091516,1955691,971731,76845,401041,7496824,44.67,5.53
Tender_1842,1679554,180285,741407,948383,289180,3838809,54.0,4.6
Tender_1843,6623471,2694765,2249773,865130,442287,12875426,43.33,5.67
Tender_1844,9521025,1199582,685707,272653,200299,11879266,35.0,6.5
Tender_1845,914943,974836,1031968,394582,232276,3548605,36.0,6.4
Tender_1846,9205575,2402366,972967,84100,209603,12874611,45.67,5.43
Tender_1847,933280,2794876,318091,582330,276866,4905443,32.67,6.73
Tender_1848,6586107,1818715,2063565,281350,365687,11115424,47.67,5.23
Tender_1849,9606320,4362878,2030663,842593,260075,17102529,38.0,6.2
Tender_1850,3241191,1444046,2129387,463381,261392,7539397,28.0,7.2
Tender_1851,4729196,1751806,1019110,601475,143469,8245056,51.0,4.9
Tender_1852,2565874,2112578,1862259,479322,272704,7292737,21.67,7.83
Tender_1853,4314431,1513808,1287411,80097,203866,7399613,33.0,6.7
Tender_1854,8152220,859865,2526243,505374,331162,12374864,39.33,6.07
Tender_1855,7545974,1912762,2741224,545843,349643,13095446,24.33,7.57
Tender_1856,6772503,405893,1045520,969593,383448,9576957,44.33,5.57
Tender_1857,8284512,675028,931709,602874,301469,10795592,30.33,6.97
Tender_1858,5567384,1932093,1377414,335090,154600,9366581,50.33,4.97
Tender_1859,3522491,4706005,2997915,375246,388278,11989935,37.0,6.3
Tender_1860,2333455,3320720,1140065,666356,52852,7513448,41.67,5.83
Tender_1861,9727265,4410947,1705540,837748,104915,16786415,29.67,7.03
Tender_1862,9704509,1463693,2359279,486447,146894,14160822,41.67,5.83
Tender_1863,9199365,1246000,414170,324291,159044,11342870,44.33,5.57
Tender_1864,3924935,3432531,2034937,139828,448444,9980675,31.33,6.87
Tender_1865,9889413,4010786,2745564,178620,83368,16907751,35.33,6.47
Tender_1866,1896741,1551656,1489688,900143,483651,6321879,40.0,6.0
Tender_1867,9443952,2171244,2795682,299653,421855,15132386,36.33,6.37
Tender_1868,8260110,2981587,1484097,434610,373391,13533795,36.67,6.33
Tender_1869,5913482,3623684,2042663,741455,404796,12726080,43.67,5.63
Tender_1870,9824322,942413,2660041,969175,464296,14860247,31.67,6.83
Tender_1871,1059735,635936,1390241,860711,347381,4294004,44.67,5.53
Tender_1872,6282623,2513733,2378300,606845,240562,12022063,26.67,7.33
Tender_1873,8623783,1710722,2141038,710503,378131,13564177,38.0,6.2
Tender_1874,9082365,3544714,2775160,715864,257207,16375310,35.0,6.5
Tender_1875,5243615,923515,2344974,889233,253462,9654799,39.67,6.03
Tender_1876,2164883,2472520,247613,668806,134645,5688467,35.0,6.5
Tender_1877,9994076,4215847,1650097,225759,258480,16344259,37.67,6.23
Tender_1878,5398079,2847995,1634453,971562,349778,11201867,45.33,5.47
Tender_1879,8802253,3355566,2174052,738466,299224,15369561,56.0,4.4
Tender_1880,3276919,1256261,2795455,556724,361894,8247253,36.67,6.33
Tender_1881,4824800,3854634,1635044,769885,229677,11314040,38.67,6.13
Tender_1882,7203407,4778219,1635695,56325,493574,14167220,49.67,5.03
Tender_1883,5158397,4655991,273662,72786,237868,10398704,43.0,5.7
Tender_1884,2134200,1356307,2543807,726751,158046,6919111,29.33,7.07
Tender_1885,1319705,2173514,1683545,448620,414953,6040337,29.67,7.03
Tender_1886,9075004,3097659,2782428,675486,254543,15885120,40.0,6.0
Tender_1887,8955973,2945353,2375735,636262,452143,15365466,41.0,5.9
Tender_1888,267378,1856254,1534570,869204,60770,4588176,29.33,7.07
Tender_1889,4097766,693567,158234,207577,264758,5421902,22.0,7.8
Tender_1890,4723262,4561560,2078917,140727,196993,11701459,28.67,7.13
Tender_1891,6933562,2256584,1605157,678960,350262,11824525,41.0,5.9
Tender_1892,7780426,2553853,1680903,213414,256114,12484710,47.0,5.3
Tender_1893,966044,2682849,1808259,686597,389916,6533665,37.33,6.27
Tender_1894,501779,3373730,930056,111283,122506,5039354,46.0,5.4
Tender_1895,7290915,454948,2295550,209388,112751,10363552,23.67,7.63
Tender_1896,1996380,2607438,1694417,348973,457282,7104490,52.67,4.73
Tender_1897,7288965,4416338,781544,382643,346340,13215830,38.0,6.2
Tender_1898,3802737,4508390,998497,81876,303097,9694597,33.67,6.63
Tender_1899,9257794,1784704,868552,511003,275510,12697563,51.0,4.9
Tender_1900,4651027,2917856,2290559,450248,232273,10541963,36.67,6.33
Tender_1901,8427717,3387784,2367905,238779,431572,14853757,54.67,4.53
Tender_1902,4201967,1771960,1179014,355858,496586,8005385,33.67,6.63
Tender_1903,8776188,2488232,369140,607341,314354,12555255,27.67,7.23
Tender_1904,1423706,4199257,240167,473380,325665,6662175,28.67,7.13
Tender_1905,691827,928393,2830982,333726,259344,5044272,42.67,5.73
Tender_1906,6849137,3712409,351707,325820,394702,11633775,33.33,6.67
Tender_1907,4316296,4740328,2009086,652384,63967,11782061,21.33,7.87
Tender_1908,8559501,4521378,2445359,853504,419632,16799374,28.67,7.13
Tender_1909,275647,590212,1509295,764781,337271,3477206,54.0,4.6
Tender_1910,7569037,992694,2297629,670184,109296,11638840,38.0,6.2
Tender_1911,3019640,4060085,71536,616381,428002,8195644,32.33,6.77
Tender_1912,1382712,3939212,2963495,160995,494654,8941068,33.0,6.7
Tender_1913,9629889,822131,1197624,944047,486642,13080333,46.33,5.37
Tender_1914,6442816,586094,2589888,414016,138382,10171196,34.67,6.53
Tender_1915,814363,4672310,1600808,665269,234225,7986975,43.67,5.63
Tender_1916,9612217,3723793,1791665,762581,113456,16003712,37.33,6.27
Tender_1917,2342709,3391844,2845503,408174,385775,9374005,40.67,5.93
Tender_1918,2496390,3176836,1805046,152977,420480,8051729,52.0,4.8
Tender_1919,6798523,2283781,272240,717778,93337,10165659,54.33,4.57
Tender_1920,1288413,432797,964498,941339,164519,3791566,33.67,6.63
Tender_1921,6905101,3418532,1376073,529480,169505,12398691,42.67,5.73
Tender_1922,4363531,3138601,1838886,555222,374421,10270661,28.0,7.2
Tender_1923,5345844,325015,2992093,332690,322715,9318357,39.67,6.03
Tender_1924,972064,534136,808134,307796,357480,2979610,29.33,7.07
Tender_1925,5965942,1321004,858170,349279,311826,8806221,46.67,5.33
Tender_1926,4929687,1755270,2900469,104218,299789,9989433,31.67,6.83
Tender_1927,6738856,3202830,2359525,198741,140742,12640694,25.33,7.47
Tender_1928,4992786,3478599,154721,133229,445017,9204352,41.33,5.87
Tender_1929,8711901,2641310,695853,692893,309685,13051642,48.33,5.17
Tender_1930,5681682,799081,1472797,566319,76403,8596282,38.33,6.17
Tender_1931,540286,2606278,1405314,892903,350886,5795667,28.33,7.17
Tender_1932,2077173,382982,1609404,115274,486385,4671218,52.0,4.8
Tender_1933,8186640,4054505,2066634,972741,189157,15469677,24.0,7.6
Tender_1934,6025310,3904204,2364727,227962,85534,12607737,46.0,5.4
Tender_1935,3060870,1022536,412479,68739,249224,4813848,24.33,7.57
Tender_1936,5390184,2215967,2073772,485052,340709,10505684,47.67,5.23
Tender_1937,1227256,1302008,2531388,281034,211644,5553330,47.33,5.27
Tender_1938,331899,782483,1249885,988515,82480,3435262,24.67,7.53
Tender_1939,1410816,289614,1744112,330659,258652,4033853,33.33,6.67
Tender_1940,7821774,2765510,860008,592148,405128,12444568,47.33,5.27
Tender_1941,6342147,2679298,680687,263093,87005,10052230,54.33,4.57
Tender_1942,6276192,2155108,2844487,227171,499391,12002349,28.0,7.2
Tender_1943,612334,2875962,2610940,283718,241004,6623958,33.33,6.67
Tender_1944,5113998,820075,1498398,370627,303367,8106465,30.33,6.97
Tender_1945,4195521,1704484,540885,955267,407871,7804028,31.0,6.9
Tender_1946,5662073,3811413,1221050,587153,150133,11431822,40.33,5.97
Tender_1947,7747974,941475,2818938,494384,478972,12481743,47.67,5.23
Tender_1948,9397217,4352776,1769431,254592,272341,16046357,40.33,5.97
Tender_1949,2131463,2061775,1965050,327888,174671,6660847,35.33,6.47
Tender_1950,5040565,2289006,1348150,140474,238190,9056385,28.0,7.2
Tender_1951,1770672,4218712,1958074,433494,266481,8647433,44.33,5.57
Tender_1952,2738491,4977156,279490,863446,91304,8949887,28.0,7.2
Tender_1953,8115426,4906701,2785238,989463,476403,17273231,40.33,5.97
Tender_1954,8345372,1352645,679785,220677,366031,10964510,52.0,4.8
Tender_1955,600970,1387171,904895,156233,444780,3494049,25.33,7.47
Tender_1956,1470063,955250,2006018,269915,406730,5107976,32.67,6.73
Tender_1957,6252099,591669,1575937,634960,71653,9126318,32.67,6.73
Tender_1958,4222032,4686981,1735698,821221,275929,11741861,34.33,6.57
Tender_1959,3447465,456308,2883035,491654,125101,7403563,39.33,6.07
Tender_1960,8938638,3801589,501210,553251,386267,14180955,33.33,6.67
Tender_1961,8502966,3841871,2650615,718296,333488,16047236,42.67,5.73
Tender_1962,2467600,4645296,220283,377281,149302,7859762,50.67,4.93
Tender_1963,9240086,3216650,1099936,149396,457371,14163439,32.0,6.8
Tender_1964,4205083,4354686,820758,723568,252636,10356731,40.33,5.97
Tender_1965,3025669,2813668,1216160,511397,57241,7624135,55.67,4.43
Tender_1966,2285954,818539,1145170,949412,67847,5266922,17.33,8.27
Tender_1967,2785154,1561888,2723206,169449,256609,7496306,40.33,5.97
Tender_1968,4240035,4413912,2770072,316110,474044,12214173,37.33,6.27
Tender_1969,8625789,1349613,1748833,368250,216533,12309018,34.0,6.6
Tender_1970,2276671,1087917,579695,590404,108882,4643569,43.67,5.63
Tender_1971,1547768,3975989,1325068,419187,107011,7375023,47.0,5.3
Tender_1972,9483498,3737449,428899,831236,274355,14755437,53.0,4.7
Tender_1973,8426184,3698635,1836263,698310,314448,14973840,43.33,5.67
Tender_1974,4863625,586941,2779342,58235,455332,8743475,27.67,7.23
Tender_1975,959669,2006496,2140240,874347,55658,6036410,38.33,6.17
Tender_1976,1128648,4556516,1190639,537894,428150,7841847,50.33,4.97
Tender_1977,8517175,2078319,2467329,119655,165777,13348255,47.0,5.3
Tender_1978,4428295,2294802,1987701,306123,99567,9116488,29.0,7.1
Tender_1979,3948948,4218786,1205269,637904,186039,10196946,34.33,6.57
Tender_1980,2605721,4507208,2274445,312216,96306,9795896,27.33,7.27
Tender_1981,6687164,3710816,2588765,399656,478269,13864670,48.33,5.17
Tender_1982,2960397,1350092,2652403,889538,173687,8026117,48.33,5.17
Tender_1983,9202560,3535061,1549429,462517,388712,15138279,45.0,5.5
Tender_1984,4435981,2402002,2354116,596461,294644,10083204,33.0,6.7
Tender_1985,3756290,3640065,1015903,344903,242876,9000037,35.0,6.5
Tender_1986,3004769,803825,2417518,428567,445008,7099687,56.0,4.4
Tender_1987,3952816,3423748,1664902,631608,386897,10059971,35.33,6.47
Tender_1988,8359628,1098887,233262,446939,357418,10496134,57.0,4.3
Tender_1989,6649962,2884197,1164026,142984,127204,10968373,42.67,5.73
Tender_1990,895824,537364,2176170,500979,274680,4385017,37.67,6.23
Tender_1991,3772755,659519,897667,902538,114426,6346905,45.33,5.47
Tender_1992,5559650,4564556,520430,955507,387472,11987615,45.0,5.5
Tender_1993,6525297,3551948,2202439,217615,434037,12931336,28.67,7.13
Tender_1994,8150603,280606,626086,342858,131387,9531540,51.33,4.87
Tender_1995,2525124,2931273,327470,939869,273267,6997003,49.0,5.1
Tender_1996,4884892,208244,496764,577562,187787,6355249,43.67,5.63
Tender_1997,4787536,2089056,2340251,337540,81503,9635886,42.0,5.8
Tender_1998,2641418,2843121,561518,865957,188388,7100402,27.0,7.3
Tender_1999,4993690,386933,1301125,279988,71691,7033427,50.0,5.0
Tender_2000,8273715,209792,2224589,881796,280341,11870233,50.0,5.0
Tender_2001,3089643,4284485,1613695,866418,355295,10209536,44.67,5.53
Tender_2002,2522106,4581428,183376,983745,337206,8607861,52.33,4.77
Tender_2003,2838012,3505852,1825655,627885,137954,8935358,34.67,6.53
Tender_2004,7310241,674346,489185,584559,394950,9453281,34.67,6.53
Tender_2005,5007675,909322,2405353,984116,488136,9794602,53.0,4.7
Tender_2006,8233944,2239503,1887970,701484,63102,13126003,40.0,6.0
Tender_2007,2703754,281785,2477975,860048,381353,6704915,28.33,7.17
Tender_2008,8614307,3991427,2506235,278185,272535,15662689,33.67,6.63
Tender_2009,4351231,3713995,1837485,813549,150595,10866855,33.33,6.67
Tender_2010,4309927,3890808,1092614,293323,179112,9765784,31.67,6.83
Tender_2011,3879046,270288,1112892,777599,99953,6139778,36.0,6.4
Tender_2012,5311817,2041162,2814015,93383,222207,10482584,31.0,6.9
Tender_2013,4160372,2626699,1227652,733212,398138,9146073,47.67,5.23
Tender_2014,2860785,3999223,147327,798677,81168,7887180,39.33,6.07
Tender_2015,6554738,272254,1760133,944266,265309,9796700,39.0,6.1
Tender_2016,938160,386092,206045,897415,384056,2811768,35.33,6.47
Tender_2017,3838089,4344058,2252162,313219,303069,11050597,28.33,7.17
Tender_2018,3223661,1200721,2401802,349241,370335,7545760,38.33,6.17
Tender_2019,2484033,3417410,797231,642345,139301,7480320,37.0,6.3
Tender_2020,2715737,1702997,1351576,829665,269093,6869068,38.67,6.13
Tender_2021,7674270,4154095,2021449,622515,192481,14664810,45.67,5.43
Tender_2022,5741804,2617864,2845743,120912,138742,11465065,30.67,6.93
Tender_2023,6499359,3538263,2527134,911928,56123,13532807,30.67,6.93
Tender_2024,1882794,2471262,604041,808023,407094,6173214,48.0,5.2
Tender_2025,8570162,3246907,2790222,597720,284816,15489827,42.33,5.77
Tender_2026,6137317,1372208,642002,781213,92966,9025706,51.67,4.83
Tender_2027,9052839,1238862,739341,692210,141614,11864866,36.0,6.4
Tender_2028,3792244,3014342,2622977,894260,88977,10412800,24.0,7.6
Tender_2029,5320482,462756,2130636,384074,101790,8399738,37.67,6.23
Tender_2030,4765089,3855639,2282541,926087,152844,11982200,27.33,7.27
Tender_2031,1401511,2284641,910376,591784,479259,5667571,37.0,6.3
Tender_2032,7856707,3935791,136677,168092,378237,12475504,40.67,5.93
Tender_2033,3873644,3752349,2676848,935622,497346,11735809,40.0,6.0
Tender_2034,624948,1508014,2478494,930267,321362,5863085,49.67,5.03
Tender_2035,8709689,885532,2640916,198722,291890,12726749,34.0,6.6
Tender_2036,1604730,4827040,399500,273846,112155,7217271,27.67,7.23
Tender_2037,8849389,4694043,1921837,834544,456598,16756411,31.67,6.83
Tender_2038,1599343,4915908,2446579,717868,133830,9813528,21.0,7.9
Tender_2039,9835260,2138629,784565,585438,484563,13828455,32.67,6.73
Tender_2040,2605130,4657749,2902166,761520,467045,11393610,31.33,6.87
Tender_2041,5048282,1917193,811057,705360,286173,8768065,45.0,5.5
Tender_2042,2586832,2777704,2618892,906343,63386,8953157,34.0,6.6
Tender_2043,4897115,4885245,897374,758450,323818,11762002,42.67,5.73
Tender_2044,2036032,2025371,2885684,460816,172444,7580347,50.67,4.93
Tender_2045,3061550,213533,2503960,526998,355237,6661278,33.0,6.7
Tender_2046,7537083,728805,2316393,280123,290166,11152570,36.67,6.33
Tender_2047,3998703,3395036,2548614,672279,427589,11042221,45.0,5.5
Tender_2048,6176079,4353283,311185,534409,108061,11483017,57.33,4.27
Tender_2049,8459061,2236918,2197841,678510,426692,13999022,32.0,6.8
Tender_2050,6415993,4841895,1525988,454256,384096,13622228,51.0,4.9
Tender_2051,2900251,3816551,1504845,78310,224262,8524219,37.67,6.23
Tender_2052,2504604,614395,991431,77828,499510,4687768,34.33,6.57
Tender_2053,8802547,3803235,729924,602120,153037,14090863,37.33,6.27
Tender_2054,8727548,654063,2060122,488267,450967,12380967,41.67,5.83
Tender_2055,4022723,1176741,2132528,806909,436236,8575137,49.67,5.03
Tender_2056,2699028,3132651,2904352,50321,497863,9284215,47.33,5.27
Tender_2057,722596,4154815,2006444,737335,207770,7828960,38.33,6.17
Tender_2058,3897260,2843728,2036994,560267,313102,9651351,34.33,6.57
Tender_2059,8422113,1102831,188102,599700,286770,10599516,49.0,5.1
Tender_2060,4591265,967033,1546063,84630,100155,7289146,29.0,7.1
Tender_2061,9380909,3940620,1611839,354412,155512,15443292,49.67,5.03
Tender_2062,805411,750007,2824769,651022,211556,5242765,27.67,7.23
Tender_2063,645456,2219104,260866,660270,483405,4269101,32.33,6.77
Tender_2064,3156222,2580057,931426,87711,381171,7136587,40.0,6.0
Tender_2065,4067247,310103,2000263,279284,68799,6725696,38.0,6.2
Tender_2066,7036851,1713684,432331,268494,411236,9862596,22.33,7.77
Tender_2067,7627353,2494504,2295502,220737,329292,12967388,56.67,4.33
Tender_2068,7562302,1592977,366335,822333,456612,10800559,37.0,6.3
Tender_2069,9152378,4601753,2885769,818461,152031,17610392,41.0,5.9
Tender_2070,6369769,3927284,2691403,765405,347533,14101394,30.0,7.0
Tender_2071,1592287,2777656,2548552,940093,294825,8153413,38.0,6.2
Tender_2072,4823622,3494239,1652170,901747,236242,11108020,41.0,5.9
Tender_2073,6064184,3808881,649044,449920,393770,11365799,45.33,5.47
Tender_2074,5965086,1789533,1340667,255740,289378,9640404,38.33,6.17
Tender_2075,4723713,1050264,2965453,157595,381005,9278030,28.33,7.17
Tender_2076,5429136,992726,2033371,237036,94947,8787216,34.67,6.53
Tender_2077,4966626,496575,1843386,884779,160435,8351801,35.33,6.47
Tender_2078,4786360,1147858,1761426,982430,426135,9104209,35.0,6.5
Tender_2079,5332415,4001529,2909513,750928,200829,13195214,30.67,6.93
Tender_2080,2563759,3322714,1375627,847613,377659,8487372,52.33,4.77
Tender_2081,7972326,3334304,2524027,398531,445880,14675068,35.33,6.47
Tender_2082,3932848,120423,82661,727204,246115,5109251,40.0,6.0
Tender_2083,8408363,1629141,1469527,158276,231728,11897035,34.67,6.53
Tender_2084,2663356,3791600,890369,866928,124188,8336441,57.0,4.3
Tender_2085,7386704,869146,1172019,750150,130085,10308104,40.0,6.0
Tender_2086,9631381,1213980,2547270,848157,444261,14685049,52.33,4.77
Tender_2087,3356753,3577280,2779635,540993,245058,10499719,32.0,6.8
Tender_2088,2944398,734481,2066197,509084,469727,6723887,36.33,6.37
Tender_2089,4077797,2984602,1541369,495568,310918,9410254,47.33,5.27
Tender_2090,3625874,2423993,1890627,676012,277644,8894150,41.67,5.83
Tender_2091,4456938,408104,1104969,606768,416587,6993366,27.0,7.3
Tender_2092,9142059,4405359,1270219,267352,489985,15574974,39.33,6.07
Tender_2093,3776875,3173039,1422698,752736,432347,9557695,57.67,4.23
Tender_2094,3602534,3462044,371743,476491,221045,8133857,38.33,6.17
Tender_2095,8340060,795843,280345,954617,52729,10423594,28.67,7.13
Tender_2096,6122226,142127,501656,547386,451360,7764755,47.0,5.3
Tender_2097,6439705,2023671,2697081,746448,71491,11978396,34.33,6.57
Tender_2098,7705984,1793412,2880778,176060,498563,13054797,45.67,5.43
Tender_2099,3872277,2602037,1545898,981952,436899,9439063,56.33,4.37
Tender_2100,8464173,4793249,2439147,300968,293615,16291152,32.0,6.8
Tender_2101,9282741,1122624,2390705,654552,195686,13646308,47.0,5.3
Tender_2102,5908870,585042,1104638,69850,195676,7864076,35.33,6.47
Tender_2103,1749732,594937,1475663,988751,369324,5178407,40.33,5.97
Tender_2104,4089987,2133265,1563855,630075,101202,8518384,44.33,5.57
Tender_2105,3486609,1705249,1512133,632575,199623,7536189,24.33,7.57
Tender_2106,1480855,2718186,1104368,427905,132416,5863730,45.67,5.43
Tender_2107,1996977,2953923,1452343,947308,147271,7497822,33.33,6.67
Tender_2108,6732872,1862449,1789800,749121,169166,11303408,42.67,5.73
Tender_2109,5734784,4916002,620554,108759,378977,11759076,44.0,5.6
Tender_2110,3816894,1685046,947221,595693,196515,7241369,48.33,5.17
Tender_2111,2110235,1028255,784390,391718,292098,4606696,38.67,6.13
Tender_2112,2634155,4091124,341486,320253,94443,7481461,28.67,7.13
Tender_2113,7248312,2699765,1960154,210710,355391,12474332,44.33,5.57
Tender_2114,4432403,1188248,2441486,339565,415662,8817364,37.33,6.27
Tender_2115,6010724,1311583,461320,94864,79149,7957640,35.67,6.43
Tender_2116,6595967,880170,1203111,175758,229066,9084072,39.0,6.1
Tender_2117,6544946,3735451,2951879,957194,292377,14481847,42.33,5.77
Tender_2118,7662719,3136706,2884088,204855,482563,14370931,44.33,5.57
Tender_2119,6105479,4986659,104866,862550,182701,12242255,32.33,6.77
Tender_2120,7635560,4302698,484706,579532,113020,13115516,48.67,5.13
Tender_2121,785894,910306,2228808,231119,456424,4612551,50.33,4.97
Tender_2122,6144818,812104,2764188,555318,283747,10560175,35.33,6.47
Tender_2123,8214255,3129138,1664429,251566,374951,13634339,35.0,6.5
Tender_2124,1996399,4100660,1129171,141067,481160,7848457,24.67,7.53
Tender_2125,8233309,4836285,846291,435790,158997,14510672,30.0,7.0
Tender_2126,1770469,854078,1496389,356991,396559,4874486,41.0,5.9
Tender_2127,6268221,1764042,2018729,206459,143045,10400496,40.67,5.93
Tender_2128,1657147,3346484,363239,141716,94547,5603133,55.67,4.43
Tender_2129,9258130,3822380,1754316,934513,389736,16159075,52.0,4.8
Tender_2130,3943033,4480869,368818,187395,231486,9211601,35.33,6.47
Tender_2131,4058651,2965719,2139843,424763,200147,9789123,48.0,5.2
Tender_2132,4000162,2173610,112308,590358,207749,7084187,58.67,4.13
Tender_2133,4097413,3812011,656244,607421,71885,9244974,35.67,6.43
Tender_2134,6341379,1319683,2567148,539629,360121,11127960,46.67,5.33
Tender_2135,6834815,4638192,2028817,103538,341233,13946595,34.67,6.53
Tender_2136,3000045,599080,800004,475181,300739,5175049,36.0,6.4
Tender_2137,6439860,3372760,2146180,389167,185496,12533463,52.0,4.8
Tender_2138,5849998,2116263,635016,985607,459094,10045978,40.67,5.93
Tender_2139,487112,3305682,281406,535372,109064,4718636,47.33,5.27
Tender_2140,2253426,4674427,610696,876184,319940,8734673,49.0,5.1
Tender_2141,3652976,1220286,2450742,105220,122567,7551791,52.67,4.73
Tender_2142,5824200,2290007,1130096,239514,263626,9747443,36.0,6.4
Tender_2143,9444970,4478977,1556302,754595,109932,16344776,31.67,6.83
Tender_2144,5318472,724414,1476616,322433,368439,8210374,31.0,6.9
Tender_2145,2099911,4228822,2909355,329576,369375,9937039,34.33,6.57
Tender_2146,1123307,1660812,1259439,808499,316831,5168888,59.33,4.07
Tender_2147,4273016,4233431,1872429,434163,362848,11175887,34.0,6.6
Tender_2148,4568427,971299,2469489,207193,52912,8269320,47.33,5.27
Tender_2149,1595263,1925908,2019483,108959,226638,5876251,33.0,6.7
Tender_2150,1509305,668224,771703,661304,126025,3736561,40.0,6.0
Tender_2151,4109328,874908,1857340,603267,263739,7708582,42.33,5.77
Tender_2152,7600662,2846908,418452,179963,350767,11396752,41.67,5.83
Tender_2153,3430654,4421072,1158630,359493,490059,9859908,41.67,5.83
Tender_2154,2529865,1513718,647799,591164,344552,5627098,55.67,4.43
Tender_2155,596401,2849299,1177184,172771,435268,5230923,39.67,6.03
Tender_2156,2348748,518427,1343332,629146,100206,4939859,47.33,5.27
Tender_2157,2419587,4619596,2231664,979255,200351,10450453,26.33,7.37
Tender_2158,738075,2545950,935542,980509,337667,5537743,23.33,7.67
Tender_2159,1592874,1885595,2641046,440379,320421,6880315,34.0,6.6
Tender_2160,7835090,2437512,1120727,360064,291448,12044841,46.0,5.4
Tender_2161,4033808,1643224,468804,613151,89882,6848869,47.67,5.23
Tender_2162,9260846,884912,1946500,101685,55875,12249818,30.33,6.97
Tender_2163,3135142,1083846,1574027,732401,265912,6791328,32.0,6.8
Tender_2164,2315461,1442936,2125186,433569,358205,6675357,48.33,5.17
Tender_2165,7415836,894722,722835,769300,228325,10031018,31.33,6.87
Tender_2166,859515,4682724,955743,61957,422014,6981953,47.0,5.3
Tender_2167,6857369,1634917,261423,99303,485239,9338251,32.67,6.73
Tender_2168,9242011,4611721,2380863,996175,254594,17485364,52.0,4.8
Tender_2169,6807995,4504469,2624301,803481,147630,14887876,44.0,5.6
Tender_2170,9532912,1512327,1700831,698458,220172,13664700,32.0,6.8
Tender_2171,7143043,892756,330791,593103,489563,9449256,45.67,5.43
Tender_2172,7266570,2275608,2912864,402619,456090,13313751,38.67,6.13
Tender_2173,4064850,3033887,635461,147027,90208,7971433,40.33,5.97
Tender_2174,212305,2706021,2738979,502523,206286,6366114,35.67,6.43
Tender_2175,8263349,4027369,1777832,576558,256992,14902100,39.33,6.07
Tender_2176,476710,467590,2512485,441611,232271,4130667,21.0,7.9
Tender_2177,7131573,2785166,1233906,66016,450594,11667255,41.33,5.87
Tender_2178,4961714,2468700,1203559,383626,327806,9345405,41.0,5.9
Tender_2179,9325740,2183226,1657070,195191,355975,13717202,39.67,6.03
Tender_2180,9257734,1855702,1510775,857244,419177,13900632,46.67,5.33
Tender_2181,7037506,1590255,1568569,955000,147165,11298495,45.33,5.47
Tender_2182,4031079,883289,438755,649798,407004,6409925,42.67,5.73
Tender_2183,8749983,1390549,2000155,306326,256289,12703302,23.0,7.7
Tender_2184,7800185,2790118,957603,398612,470831,12417349,34.0,6.6
Tender_2185,5446981,3107019,2031175,317534,375604,11278313,50.67,4.93
Tender_2186,7400846,2561305,612993,180840,465723,11221707,47.67,5.23
Tender_2187,9607148,1713022,1095221,73429,255938,12744758,53.0,4.7
Tender_2188,1854470,1279863,1242042,525190,174640,5076205,42.67,5.73
Tender_2189,9866478,2416356,612222,987625,89480,13972161,37.0,6.3
Tender_2190,3036259,2549428,2879343,953181,279623,9697834,37.33,6.27
Tender_2191,9751298,1905713,1025980,284454,300464,13267909,42.33,5.77
Tender_2192,5770430,1639295,2176261,518422,294071,10398479,48.0,5.2
Tender_2193,9832703,1558378,667047,874725,415199,13348052,21.0,7.9
Tender_2194,1557119,599993,898292,207039,114036,3376479,33.33,6.67
Tender_2195,1649751,4013399,2337790,105865,323616,8430421,42.0,5.8
Tender_2196,502055,4415431,2616041,604031,95401,8232959,34.33,6.57
Tender_2197,2359362,1021336,698270,920726,171992,5171686,33.33,6.67
Tender_2198,9016238,306286,1449245,584479,64821,11421069,46.33,5.37
Tender_2199,5320290,2870981,1764257,183432,440737,10579697,36.33,6.37
Tender_2200,9961876,349148,1481407,240640,247123,12280194,43.67,5.63
Tender_2201,3682787,4699311,2369986,423137,114542,11289763,42.0,5.8
Tender_2202,9025169,4996327,1109760,518855,134094,15784205,40.67,5.93
Tender_2203,3388303,4774736,1861020,328394,97126,10449579,52.0,4.8
Tender_2204,5565882,2364423,1646488,458345,142543,10177681,43.0,5.7
Tender_2205,438584,541514,881008,378621,265239,2504966,27.33,7.27
Tender_2206,9739266,4634862,2071761,722078,315161,17483128,42.0,5.8
Tender_2207,4307415,793102,1757579,909333,175222,7942651,32.67,6.73
Tender_2208,2655992,3500152,2988770,341000,182324,9668238,40.67,5.93
Tender_2209,7636816,3969811,2148024,719775,134181,14608607,42.33,5.77
Tender_2210,6392501,1447694,695980,315325,162837,9014337,22.67,7.73
Tender_2211,3394149,2147395,2261988,600140,415324,8818996,41.67,5.83
Tender_2212,2355884,1894386,2031323,91414,453556,6826563,35.67,6.43
Tender_2213,6718978,3471082,1196949,501655,107703,11996367,19.0,8.1
Tender_2214,5063399,2151386,2759321,257768,351601,10583475,34.67,6.53
Tender_2215,8599308,3222282,693252,961206,449982,13926030,44.0,5.6
Tender_2216,6848995,937637,2735831,736885,278565,11537913,32.0,6.8
Tender_2217,3406421,467068,1370308,885770,273140,6402707,33.33,6.67
Tender_2218,2305955,3992783,2617194,325961,406176,9648069,46.67,5.33
Tender_2219,1125794,1920300,1224364,929798,72484,5272740,44.67,5.53
Tender_2220,1571667,4403367,882585,360130,74248,7291997,38.33,6.17
Tender_2221,4268610,3237433,2063395,828957,230796,10629191,53.67,4.63
Tender_2222,419391,627950,1079713,464009,401696,2992759,28.67,7.13
Tender_2223,6849286,2761972,1601522,587622,317224,12117626,37.0,6.3
Tender_2224,5617729,1931381,2432865,92119,304630,10378724,43.33,5.67
Tender_2225,3508195,2521426,2722096,220961,444927,9417605,55.67,4.43
Tender_2226,3581641,1881686,541391,299843,401988,6706549,43.33,5.67
Tender_2227,3080078,3131904,2281694,354994,207865,9056535,34.33,6.57
Tender_2228,4178733,3658659,317186,76275,436424,8667277,52.33,4.77
Tender_2229,6776978,4104316,1517258,562392,356837,13317781,51.33,4.87
Tender_2230,1387502,2494649,2175249,73847,379734,6510981,34.0,6.6
Tender_2231,1839788,698923,54971,239278,366099,3199059,30.67,6.93
Tender_2232,9563177,2992851,2154421,481056,389370,15580875,49.0,5.1
Tender_2233,6529390,2513724,1115748,728273,211130,11098265,45.0,5.5
Tender_2234,6578077,150761,2520367,509358,236742,9995305,51.67,4.83
Tender_2235,5385942,2630369,2925517,805983,177202,11925013,52.33,4.77
Tender_2236,2059875,3614029,2888632,191392,101474,8855402,28.0,7.2
Tender_2237,1439874,901320,2706076,848262,105966,6001498,56.33,4.37
Tender_2238,5886716,3827771,2524247,738476,65040,13042250,42.33,5.77
Tender_2239,1762648,2422655,1204553,500165,131043,6021064,24.0,7.6
Tender_2240,6665043,3180917,2109305,93415,464065,12512745,37.67,6.23
Tender_2241,5122921,2777183,1836771,163524,357032,10257431,46.0,5.4
Tender_2242,4429804,3538530,2686989,577400,52747,11285470,46.33,5.37
Tender_2243,7126389,1739021,1657324,954203,158243,11635180,26.33,7.37
Tender_2244,5790623,4199496,2681914,610231,260798,13543062,45.33,5.47
Tender_2245,2670288,4760860,728199,847443,256431,9263221,33.33,6.67
Tender_2246,3419140,423562,2077234,59712,313399,6293047,40.0,6.0
Tender_2247,7168462,1110255,994943,920279,194614,10388553,44.0,5.6
Tender_2248,6489147,4464554,2330027,296388,53122,13633238,40.0,6.0
Tender_2249,8125578,4163684,2002825,599080,471159,15362326,49.67,5.03
Tender_2250,9619643,916023,598506,943726,484081,12561979,26.67,7.33
Tender_2251,2739044,2835734,1149439,172169,301984,7198370,34.67,6.53
Tender_2252,7456642,851691,2359774,355047,212562,11235716,27.0,7.3
Tender_2253,515349,2004207,2324910,380984,114039,5339489,46.33,5.37
Tender_2254,1068745,172728,1754747,699689,373635,4069544,29.0,7.1
Tender_2255,9042356,144244,849344,63466,438164,10537574,25.33,7.47
Tender_2256,447895,3422209,1390931,965059,397182,6623276,50.67,4.93
Tender_2257,259760,1685477,2849158,682540,438489,5915424,35.67,6.43
Tender_2258,4928016,2589399,2520394,567955,343980,10949744,26.33,7.37
Tender_2259,7839059,397194,669655,63563,175361,9144832,26.33,7.37
Tender_2260,252124,3607964,811338,532530,317635,5521591,48.0,5.2
Tender_2261,3540497,909922,519907,710041,477233,6157600,58.33,4.17
Tender_2262,3342803,1566427,1763585,601561,281026,7555402,33.33,6.67
Tender_2263,2888759,4909159,2470395,201538,286890,10756741,41.67,5.83
Tender_2264,7182671,1478846,1002426,356259,459353,10479555,59.0,4.1
Tender_2265,872213,3262143,992072,833125,178325,6137878,30.67,6.93
Tender_2266,415089,1348360,2119534,919551,114592,4917126,32.33,6.77
Tender_2267,9062424,2011707,1557438,628168,328310,13588047,31.67,6.83
Tender_2268,8655066,3348812,2837933,775348,302739,15919898,32.33,6.77
Tender_2269,9114771,1023906,2728451,135408,345108,13347644,20.33,7.97
Tender_2270,5334601,4657049,838505,360326,335142,11525623,37.67,6.23
Tender_2271,3383762,1033284,1753721,648021,280084,7098872,38.33,6.17
Tender_2272,9649019,3168546,395026,357047,331907,13901545,24.67,7.53
Tender_2273,1556736,3783341,1167228,346005,488458,7341768,48.33,5.17
Tender_2274,3575746,4015358,903711,148625,86056,8729496,39.33,6.07
Tender_2275,4686069,3814783,770177,126382,89434,9486845,55.0,4.5
Tender_2276,7909401,3510726,1694083,173859,105111,13393180,45.0,5.5
Tender_2277,4313278,2509587,2572808,466868,486169,10348710,36.33,6.37
Tender_2278,2174619,1205374,2613625,838025,163343,6994986,38.67,6.13
Tender_2279,559950,1790470,1605673,790804,147108,4894005,49.67,5.03
Tender_2280,6325905,4020497,963949,324563,480894,12115808,48.0,5.2
Tender_2281,3767956,4550453,2017818,642621,279972,11258820,53.33,4.67
Tender_2282,9631835,4308981,1820599,855356,486853,17103624,42.33,5.77
Tender_2283,8886433,2753639,2197896,483450,339804,14661222,35.33,6.47
Tender_2284,9074569,410271,2314780,312285,491049,12602954,24.0,7.6
Tender_2285,3918738,3899110,2922686,705630,395062,11841226,53.0,4.7
Tender_2286,1891852,4825795,696625,935821,234795,8584888,47.0,5.3
Tender_2287,2900781,346697,1270629,670834,379171,5568112,35.67,6.43
Tender_2288,336809,2680345,277998,960726,339060,4594938,40.0,6.0
Tender_2289,5418205,3965585,2610812,344210,403181,12741993,55.33,4.47
Tender_2290,4769983,3238018,2919357,735452,147359,11810169,34.0,6.6
Tender_2291,2906061,3020867,422371,622061,89098,7060458,50.33,4.97
Tender_2292,8636911,1413286,2580399,656821,67101,13354518,47.0,5.3
Tender_2293,2629799,1753161,1164332,754367,272295,6573954,47.0,5.3
Tender_2294,4196149,179777,2680072,946545,133665,8136208,36.0,6.4
Tender_2295,7261955,2140882,540328,541726,263717,10748608,40.67,5.93
Tender_2296,2289581,1848348,762563,753205,92844,5746541,26.0,7.4
Tender_2297,7437032,2724461,733485,93270,472310,11460558,41.67,5.83
Tender_2298,757952,267489,2491925,678720,117146,4313232,33.0,6.7
Tender_2299,1633588,983793,1402118,486269,251627,4757395,19.67,8.03
Tender_2300,549994,1595122,1252951,803337,127212,4328616,37.0,6.3
Tender_2301,8455025,2009306,1952339,368133,198046,12982849,31.33,6.87
Tender_2302,2687739,1502346,136076,653787,60633,5040581,28.67,7.13
Tender_2303,9573306,4873907,1068793,448217,312433,16276656,26.67,7.33
Tender_2304,3669872,147408,1127224,388016,401914,5734434,35.67,6.43
Tender_2305,9119418,523726,2688827,322187,377616,13031774,44.67,5.53
Tender_2306,3075918,968216,2360700,441531,489358,7335723,53.67,4.63
Tender_2307,1350442,1075982,2588292,698891,138691,5852298,42.67,5.73
Tender_2308,2320755,1462847,2599932,106331,407215,6897080,52.0,4.8
Tender_2309,1785504,2335153,855914,107718,248880,5333169,27.33,7.27
Tender_2310,857925,2078000,416722,935301,481377,4769325,42.33,5.77
Tender_2311,1833612,2450068,2512832,72128,65367,6934007,40.0,6.0
Tender_2312,6271555,990752,826892,732337,127715,8949251,36.67,6.33
Tender_2313,1870336,3074939,1728419,750602,482920,7907216,33.0,6.7
Tender_2314,295392,4349615,2960181,961370,462052,9028610,33.33,6.67
Tender_2315,7162153,1367473,1344546,581372,485506,10941050,60.67,3.93
Tender_2316,990354,1266514,2636312,74696,403529,5371405,41.0,5.9
Tender_2317,8423331,802246,2574860,562960,260922,12624319,31.67,6.83
Tender_2318,8835947,1499440,742322,304004,402317,11784030,47.0,5.3
Tender_2319,5274794,803317,2370158,435761,442024,9326054,45.33,5.47
Tender_2320,9651788,3210160,2452989,97285,135145,15547367,32.0,6.8
Tender_2321,8289181,737801,2165240,978195,204338,12374755,51.33,4.87
Tender_2322,638560,968324,725137,146632,372547,2851200,43.67,5.63
Tender_2323,4922919,466453,422873,396386,387315,6595946,40.0,6.0
Tender_2324,2790809,4727527,1957156,737091,335303,10547886,52.67,4.73
Tender_2325,763386,4633660,1103454,972366,466914,7939780,39.67,6.03
Tender_2326,9957916,102302,1247866,279140,461806,12049030,33.33,6.67
Tender_2327,7541708,4648429,2647320,340260,311117,15488834,25.67,7.43
Tender_2328,7881726,4843462,1160854,603744,479955,14969741,30.67,6.93
Tender_2329,7001039,2981945,1551773,347837,123549,12006143,39.67,6.03
Tender_2330,7359348,513557,2613572,196504,210288,10893269,39.67,6.03
Tender_2331,4244518,3353883,2749182,660955,358850,11367388,39.33,6.07
Tender_2332,1920638,3515570,2181921,869709,216291,8704129,36.0,6.4
Tender_2333,756273,3225818,1711354,765513,481834,6940792,55.67,4.43
Tender_2334,1046227,2000425,2075187,742389,314078,6178306,38.33,6.17
Tender_2335,5400228,2968489,954504,635569,79116,10037906,35.67,6.43
Tender_2336,5804835,3419527,2452405,119072,275473,12071312,36.33,6.37
Tender_2337,3574559,887596,574580,370126,368749,5775610,35.0,6.5
Tender_2338,1487187,2367706,457170,638815,449764,5400642,37.67,6.23
Tender_2339,4871671,591509,499402,660607,239446,6862635,40.33,5.97
Tender_2340,2542270,304564,636592,570348,161528,4215302,59.33,4.07
Tender_2341,2455920,4701064,509997,600735,55846,8323562,35.33,6.47
Tender_2342,3802254,919568,2453211,287055,124046,7586134,25.67,7.43
Tender_2343,6636672,2627455,1691031,915025,74869,11945052,23.33,7.67
Tender_2344,5686668,3038129,331282,666192,385405,10107676,36.33,6.37
Tender_2345,4199470,1181489,2233254,76913,163214,7854340,35.33,6.47
Tender_2346,2958739,4724831,2005431,693578,159187,10541766,43.0,5.7
Tender_2347,8132987,3391441,835772,53189,83990,12497379,35.0,6.5
Tender_2348,1533565,194258,179242,659945,404666,2971676,35.67,6.43
Tender_2349,4537631,3476047,300637,78802,227364,8620481,22.33,7.77
Tender_2350,8279827,4594430,353299,535132,208586,13971274,44.0,5.6
Tender_2351,3197207,1409780,106679,169713,111749,4995128,35.0,6.5
Tender_2352,6006319,835394,626551,522801,171515,8162580,54.67,4.53
Tender_2353,417457,4155976,2563727,85211,346924,7569295,29.33,7.07
Tender_2354,8284116,2674720,825289,182531,473146,12439802,23.0,7.7
Tender_2355,6542112,2298606,2008872,680281,155288,11685159,33.33,6.67
Tender_2356,2757894,4228425,509816,76187,318857,7891179,49.0,5.1
Tender_2357,3489150,237216,2307974,235792,236031,6506163,32.33,6.77
Tender_2358,4028330,4133993,624229,813800,66325,9666677,42.0,5.8
Tender_2359,2337214,2209741,609069,814641,162293,6132958,31.0,6.9
Tender_2360,7889694,2885918,2935382,589985,290698,14591677,35.67,6.43
Tender_2361,6448454,1551183,2644325,89739,347791,11081492,30.67,6.93
Tender_2362,863199,1264689,111054,913723,309199,3461864,26.0,7.4
Tender_2363,9957072,2588338,2483582,761662,446814,16237468,42.67,5.73
Tender_2364,4784291,2314409,1327652,170269,55529,8652150,26.33,7.37
Tender_2365,5378122,4679767,1156568,284549,149947,11648953,36.67,6.33
Tender_2366,4553431,4961509,1647809,906539,218725,12288013,39.33,6.07
Tender_2367,8833411,3814824,2110871,305057,208428,15272591,28.0,7.2
Tender_2368,3926911,3447089,1493480,935836,494825,10298141,28.67,7.13
Tender_2369,1595374,2022488,140600,189884,356479,4304825,55.0,4.5
Tender_2370,8514289,4873739,2093778,550204,105731,16137741,45.33,5.47
Tender_2371,5006394,1113780,1586567,596420,448937,8752098,49.67,5.03
Tender_2372,9949206,3273768,170105,65625,239595,13698299,35.33,6.47
Tender_2373,3792670,349850,1176469,688083,425771,6432843,34.0,6.6
Tender_2374,7165674,497287,1742736,169857,310246,9885800,55.67,4.43
Tender_2375,352399,3864889,349957,141475,218946,4927666,20.0,8.0
Tender_2376,1433308,3414083,612192,984179,109101,6552863,23.67,7.63
Tender_2377,6881276,4871828,2879130,645193,187193,15464620,32.33,6.77
Tender_2378,1570936,2524060,576099,891654,424267,5987016,45.0,5.5
Tender_2379,7519211,791397,1108666,164287,56936,9640497,54.67,4.53
Tender_2380,8797596,3607164,2115896,944207,494163,15959026,49.67,5.03
Tender_2381,8159460,2833858,505958,362739,193288,12055303,33.67,6.63
Tender_2382,6633565,4781047,1225453,586346,183206,13409617,31.67,6.83
Tender_2383,3949594,3996606,389980,630897,209219,9176296,48.67,5.13
Tender_2384,719253,322194,377330,247638,454724,2121139,46.67,5.33
Tender_2385,8335348,712139,1729363,535801,225017,11537668,45.33,5.47
Tender_2386,3557134,3021597,2126021,562028,384157,9650937,41.67,5.83
Tender_2387,8003890,1157158,909004,924954,158038,11153044,40.67,5.93
Tender_2388,2928545,3019830,2619118,903972,307783,9779248,45.67,5.43
Tender_2389,2750080,538778,2693611,263977,257084,6503530,34.33,6.57
Tender_2390,5503618,3602259,2943335,899910,81814,13030936,47.33,5.27
Tender_2391,8270671,2153578,1843789,968021,461847,13697906,34.67,6.53
Tender_2392,6444193,2919316,1334947,415755,397273,11511484,26.33,7.37
Tender_2393,9347760,2590421,1479280,937499,81848,14436808,27.0,7.3
Tender_2394,4584619,1024280,233682,945398,265484,7053463,48.0,5.2
Tender_2395,9102658,3736058,1709644,495270,298375,15342005,50.33,4.97
Tender_2396,4243216,3820875,2143535,782471,289817,11279914,27.33,7.27
Tender_2397,6958764,4510375,1864110,571237,485383,14389869,39.33,6.07
Tender_2398,3698729,2887016,387037,124163,460242,7557187,50.0,5.0
Tender_2399,2195573,1967007,1338301,705117,175618,6381616,32.67,6.73
Tender_2400,7647704,319630,1750497,971647,161855,10851333,38.67,6.13
Tender_2401,747794,2421412,2959112,359122,53079,6540519,41.67,5.83
Tender_2402,1915534,2653239,510831,684270,253352,6017226,36.0,6.4
Tender_2403,3752207,2733155,460761,887590,261164,8094877,37.33,6.27
Tender_2404,8812368,3352185,1956664,731637,241559,15094413,42.67,5.73
Tender_2405,9550952,4003438,1988159,405909,230462,16178920,25.0,7.5
Tender_2406,9347515,2992470,1645472,403832,270424,14659713,45.33,5.47
Tender_2407,1909159,4954317,2445809,476757,485258,10271300,45.67,5.43
Tender_2408,299029,4403907,1638441,626269,145377,7113023,44.0,5.6
Tender_2409,2609144,629983,2498326,241993,98579,6078025,46.33,5.37
Tender_2410,9746029,4754556,933855,133635,123877,15691952,46.33,5.37
Tender_2411,5590453,3486301,2662407,813078,249470,12801709,35.67,6.43
Tender_2412,7609706,2145046,388650,831941,100232,11075575,57.0,4.3
Tender_2413,9514499,1240567,521416,50966,148678,11476126,25.33,7.47
Tender_2414,8917342,2620484,174008,482126,294474,12488434,37.67,6.23
Tender_2415,2322471,1854475,2611228,688916,93805,7570895,34.33,6.57
Tender_2416,3107578,1767854,2379699,104682,257289,7617102,53.67,4.63
Tender_2417,3700979,2773094,2722350,611866,208574,10016863,31.67,6.83
Tender_2418,4093523,173399,2996101,618122,59716,7940861,36.33,6.37
Tender_2419,5849278,4599802,2548768,363188,179701,13540737,40.0,6.0
Tender_2420,9088179,3057986,2951284,978566,131731,16207746,38.67,6.13
Tender_2421,7403700,853313,2331835,904836,475164,11968848,32.33,6.77
Tender_2422,2486409,1065818,873124,77413,461571,4964335,30.0,7.0
Tender_2423,3795955,1165998,2946797,258192,190770,8357712,42.0,5.8
Tender_2424,4789695,3998208,2681304,620577,344814,12434598,55.67,4.43
Tender_2425,2575868,2279820,2603586,568778,288096,8316148,37.67,6.23
Tender_2426,2402004,4396872,1953380,384618,377903,9514777,42.0,5.8
Tender_2427,4020076,939443,852706,268249,438708,6519182,48.67,5.13
Tender_2428,5094168,3316920,2429906,760318,412005,12013317,31.33,6.87
Tender_2429,2399947,1296302,1464201,430502,153757,5744709,42.33,5.77
Tender_2430,2618717,3626904,696205,931242,231879,8104947,51.67,4.83
Tender_2431,7209328,4547222,1970067,648120,291947,14666684,48.0,5.2
Tender_2432,5268463,3187390,962726,446885,63404,9928868,36.67,6.33
Tender_2433,1477376,1555591,1768272,445507,71533,5318279,43.0,5.7
Tender_2434,479503,307090,2065301,209752,473296,3534942,22.33,7.77
Tender_2435,2240316,2949929,1308739,254967,495889,7249840,31.33,6.87
Tender_2436,4537595,3687096,452122,762152,69201,9508166,29.67,7.03
Tender_2437,4808345,3569502,848502,380863,462369,10069581,53.33,4.67
Tender_2438,2567595,157860,241813,370167,293632,3631067,17.67,8.23
Tender_2439,3426308,2897580,1183081,456113,86567,8049649,58.33,4.17
Tender_2440,290293,4928567,1551652,517345,99365,7387222,32.33,6.77
Tender_2441,6294801,4830733,53823,837302,275484,12292143,26.33,7.37
Tender_2442,6592647,4891097,1147187,933061,436441,14000433,24.0,7.6
Tender_2443,6751232,1724014,1958375,881119,353083,11667823,39.33,6.07
Tender_2444,5861819,1327097,1111873,692468,93973,9087230,37.0,6.3
Tender_2445,7547630,639654,1203954,423744,286641,10101623,52.67,4.73
Tender_2446,7783205,4934171,625160,891053,196139,14429728,36.0,6.4
Tender_2447,7266293,3975078,1160148,279583,102476,12783578,35.67,6.43
Tender_2448,410782,2384466,846813,857647,344018,4843726,47.33,5.27
Tender_2449,6975255,3467179,2249757,616341,280045,13588577,49.33,5.07
Tender_2450,2012450,3243530,1005372,263655,477521,7002528,45.67,5.43
Tender_2451,2738549,3406816,1904655,512389,317168,8879577,48.67,5.13
Tender_2452,6192201,1833137,1049501,572207,272108,9919154,26.33,7.37
Tender_2453,2284832,4553252,2499578,672680,456936,10467278,53.0,4.7
Tender_2454,8353219,1341323,59503,186569,97987,10038601,35.0,6.5
Tender_2455,4529915,3220612,108702,822903,386682,9068814,34.0,6.6
Tender_2456,4194628,3529966,2103555,644852,418925,10891926,42.33,5.77
Tender_2457,5263255,486223,564432,399077,462662,7175649,29.0,7.1
Tender_2458,3093669,1420559,2815529,546623,196824,8073204,39.33,6.07
Tender_2459,2292440,4511449,928797,351537,339338,8423561,36.67,6.33
Tender_2460,670376,3823200,1802437,88357,279465,6663835,35.0,6.5
Tender_2461,9283980,3401313,2961564,844134,433249,16924240,46.67,5.33
Tender_2462,5420618,870045,1380974,393525,156559,8221721,30.33,6.97
Tender_2463,4134325,3782585,2897136,519617,99115,11432778,22.67,7.73
Tender_2464,9201592,3565405,2483820,660731,198693,16110241,40.33,5.97
Tender_2465,8789252,4606035,530133,250058,395154,14570632,42.33,5.77
Tender_2466,9644417,885746,2684530,530058,481788,14226539,44.33,5.57
Tender_2467,3554171,1955894,286673,454317,482703,6733758,32.67,6.73
Tender_2468,9714483,4348209,1862610,908344,477123,17310769,29.33,7.07
Tender_2469,647694,4828255,489768,888243,273657,7127617,56.67,4.33
Tender_2470,4376371,1077156,2254071,55385,475921,8238904,37.33,6.27
Tender_2471,1882364,280399,906099,887553,52916,4009331,45.67,5.43
Tender_2472,7502611,1191988,1443310,204650,111782,10454341,32.33,6.77
Tender_2473,7110741,430706,1502379,636553,75982,9756361,26.0,7.4
Tender_2474,4583644,4670091,1138585,618592,183139,11194051,51.0,4.9
Tender_2475,6739483,4289441,2589498,441912,282849,14343183,44.0,5.6
Tender_2476,7446762,2713051,1879509,435456,241183,12715961,44.0,5.6
Tender_2477,8875208,373006,2480772,780593,305512,12815091,46.0,5.4
Tender_2478,374486,1569737,1140796,197634,481608,3764261,35.0,6.5
Tender_2479,2716728,4568046,1223265,667870,241184,9417093,30.67,6.93
Tender_2480,6783563,4982731,2014174,849387,151760,14781615,58.33,4.17
Tender_2481,9507945,2049830,522145,779788,89273,12948981,44.33,5.57
Tender_2482,8177005,3619969,62791,948962,468465,13277192,32.33,6.77
Tender_2483,5098322,2891850,2031908,585974,213839,10821893,32.0,6.8
Tender_2484,9584786,250036,2771056,71260,386859,13063997,41.0,5.9
Tender_2485,5997424,454315,2580472,92119,173782,9298112,28.67,7.13
Tender_2486,2061315,2189819,2814553,183129,55669,7304485,32.33,6.77
Tender_2487,1923554,639616,706177,981873,396213,4647433,35.0,6.5
Tender_2488,7672669,276487,1064205,869779,479708,10362848,50.67,4.93
Tender_2489,7316588,4562743,1555246,904071,91457,14430105,41.0,5.9
Tender_2490,7364308,2751428,2598507,317776,486457,13518476,51.33,4.87
Tender_2491,2121517,3931596,1455368,895811,296223,8700515,28.33,7.17
Tender_2492,2672421,4767561,1396153,463306,448128,9747569,42.67,5.73
Tender_2493,4903160,4764170,549205,118033,83461,10418029,27.67,7.23
Tender_2494,8448076,1434926,265011,353553,107027,10608593,47.0,5.3
Tender_2495,6502602,2757894,1953391,129255,70964,11414106,44.67,5.53
Tender_2496,9455857,4493743,743484,203514,255641,15152239,24.33,7.57
Tender_2497,5669259,2373976,1428950,184067,224256,9880508,37.33,6.27
Tender_2498,7852851,1281133,1118654,917871,313971,11484480,48.67,5.13
Tender_2499,6542631,1645498,2795989,406164,148493,11538775,40.67,5.93
Tender_2500,7343199,258051,1608909,636676,327240,10174075,53.33,4.67
Tender_2501,5268577,4398098,1957073,58107,233906,11915761,49.67,5.03
Tender_2502,7377754,3263361,81962,317196,122979,11163252,27.0,7.3
Tender_2503,9655613,3082817,749945,946430,285189,14719994,30.0,7.0
Tender_2504,2844131,1157995,2119050,748507,289973,7159656,49.33,5.07
Tender_2505,7464716,545078,2894824,582629,399948,11887195,29.0,7.1
Tender_2506,6367367,3909011,2395190,989928,124963,13786459,50.33,4.97
Tender_2507,873434,4280625,2578726,325823,336328,8394936,28.67,7.13
Tender_2508,3269923,2557263,820445,927658,146458,7721747,23.67,7.63
Tender_2509,9429775,4487061,2933994,644295,320293,17815418,25.33,7.47
Tender_2510,2885240,3365906,2821770,426945,347573,9847434,17.67,8.23
Tender_2511,8137865,505095,2529016,824644,306028,12302648,32.0,6.8
Tender_2512,7832670,1607926,658656,169050,463251,10731553,52.0,4.8
Tender_2513,5189881,3065558,523789,170046,450915,9400189,19.33,8.07
Tender_2514,7088543,3512453,1341359,53093,228338,12223786,34.0,6.6
Tender_2515,4860049,2048515,1961437,429561,312972,9612534,40.67,5.93
Tender_2516,9339834,4085211,1645553,432125,377881,15880604,20.0,8.0
Tender_2517,3274873,4364741,594315,661185,242599,9137713,24.0,7.6
Tender_2518,5770895,878242,713875,463495,473086,8299593,45.33,5.47
Tender_2519,5081341,853515,2222097,895532,224001,9276486,43.33,5.67
Tender_2520,5458503,3354884,2655522,560578,100042,12129529,34.0,6.6
Tender_2521,8048596,545485,2826458,831191,431757,12683487,35.67,6.43
Tender_2522,6559342,3772777,2233578,889193,120212,13575102,21.67,7.83
Tender_2523,4280530,1348908,2442027,190104,430456,8692025,46.0,5.4
Tender_2524,5139889,3804957,2514658,785057,432937,12677498,35.0,6.5
Tender_2525,5147811,2138591,835952,594227,135896,8852477,54.33,4.57
Tender_2526,7786250,1542582,2934902,551389,427323,13242446,27.33,7.27
Tender_2527,9569965,4298000,1227907,611003,189720,15896595,29.33,7.07
Tender_2528,3075316,3210732,779833,321107,198169,7585157,43.67,5.63
Tender_2529,885120,3225756,2387367,131524,369108,6998875,32.0,6.8
Tender_2530,1002249,4228937,115434,880462,195825,6422907,16.0,8.4
Tender_2531,2030153,3972929,879780,605093,324179,7812134,52.0,4.8
Tender_2532,3414043,4090083,466343,429737,410768,8810974,37.0,6.3
Tender_2533,8426958,2337551,2758023,457710,315196,14295438,55.0,4.5
Tender_2534,6682306,4763560,233355,534771,307246,12521238,44.0,5.6
Tender_2535,8785139,2234450,2198450,871683,80556,14170278,40.0,6.0
Tender_2536,4346673,105902,1258724,765854,429751,6906904,24.67,7.53
Tender_2537,6274144,4481093,1838503,857584,417190,13868514,38.33,6.17
Tender_2538,2871484,3126601,550104,606767,359597,7514553,33.0,6.7
Tender_2539,8961648,1483066,1910660,589384,161992,13106750,26.33,7.37
Tender_2540,1497419,1611873,1511486,475151,197351,5293280,41.33,5.87
Tender_2541,4134794,4495726,2450134,808553,261911,12151118,41.67,5.83
Tender_2542,8338007,3597885,796101,275612,287297,13294902,48.67,5.13
Tender_2543,2365532,823651,1803009,232665,204373,5429230,38.0,6.2
Tender_2544,4628645,4528676,1368146,807766,385539,11718772,29.0,7.1
Tender_2545,3100149,1151971,2437845,162363,434405,7286733,46.67,5.33
Tender_2546,975745,3783974,2514448,456085,191225,7921477,23.67,7.63
Tender_2547,5027410,1335542,959868,225943,494640,8043403,40.33,5.97
Tender_2548,7238615,3527429,2204536,273625,315775,13559980,39.0,6.1
Tender_2549,6351958,154383,2699131,663861,198302,10067635,46.33,5.37
Tender_2550,4013397,3266125,2678276,192899,415410,10566107,34.33,6.57
Tender_2551,5452470,2942801,2862494,490944,426705,12175414,22.33,7.77
Tender_2552,2857278,4110845,1928912,420942,278483,9596460,28.67,7.13
Tender_2553,1315714,3737696,2736100,725611,361903,8877024,46.0,5.4
Tender_2554,8462820,4371658,2195916,951783,53542,16035719,35.33,6.47
Tender_2555,1236536,1435515,2293022,564306,362243,5891622,53.0,4.7
Tender_2556,5861636,3759919,2239821,866354,154160,12881890,43.0,5.7
Tender_2557,8173646,4047849,1393281,243755,391366,14249897,34.33,6.57
Tender_2558,2456552,1331805,2399479,848505,459189,7495530,30.33,6.97
Tender_2559,6541428,4489632,2330453,968537,248209,14578259,30.67,6.93
Tender_2560,8504138,1594512,2790561,978199,398546,14265956,54.67,4.53
Tender_2561,7826114,2678525,2961710,314755,177800,13958904,27.33,7.27
Tender_2562,9802203,977183,626142,955074,252765,12613367,40.33,5.97
Tender_2563,9437882,3967265,2343102,318754,260782,16327785,37.0,6.3
Tender_2564,3436321,4305733,548192,320264,140477,8750987,23.67,7.63
Tender_2565,932780,3476971,2222701,763477,82519,7478448,26.0,7.4
Tender_2566,996600,4348796,2384002,248880,240754,8219032,35.0,6.5
Tender_2567,2633077,462615,2512433,583187,286095,6477407,45.0,5.5
Tender_2568,1021413,2307495,1701542,106103,435607,5572160,30.67,6.93
Tender_2569,3426505,1513504,1658264,513369,412728,7524370,35.67,6.43
Tender_2570,846050,4519194,1955093,516716,58975,7896028,49.33,5.07
Tender_2571,4704144,4621448,679211,916254,477488,11398545,30.0,7.0
Tender_2572,3402296,4210167,1891266,345497,189811,10039037,26.67,7.33
Tender_2573,3568396,4387745,520426,323630,137511,8937708,45.33,5.47
Tender_2574,1018015,1457312,2214684,239622,286844,5216477,49.33,5.07
Tender_2575,8350598,2844426,1417397,137605,336324,13086350,45.33,5.47
Tender_2576,7978495,4883872,153961,358389,286934,13661651,23.33,7.67
Tender_2577,9671630,4503559,2840570,676403,282795,17974957,52.67,4.73
Tender_2578,497666,3416893,2160857,398763,449237,6923416,25.67,7.43
Tender_2579,668843,3790677,408238,905272,111623,5884653,41.67,5.83
Tender_2580,1744631,1395902,1354306,940784,429672,5865295,35.67,6.43
Tender_2581,2383923,2587040,1826752,960746,83597,7842058,26.33,7.37
Tender_2582,1692433,1121405,1095402,97007,148062,4154309,36.33,6.37
Tender_2583,6246175,3099294,1508118,372181,292363,11518131,37.33,6.27
Tender_2584,3473142,2521426,2312546,755642,317543,9380299,44.67,5.53
Tender_2585,3228125,1137631,281970,522667,86595,5256988,42.67,5.73
Tender_2586,4329336,3149898,2347389,684039,249291,10759953,29.67,7.03
Tender_2587,8632528,4065351,112262,321382,111304,13242827,36.33,6.37
Tender_2588,9314589,681899,1576571,910793,153914,12637766,40.33,5.97
Tender_2589,5381672,4085851,2721842,793645,103893,13086903,39.67,6.03
Tender_2590,1245711,3758237,2053301,885866,252087,8195202,40.0,6.0
Tender_2591,9763392,1528604,2530162,809845,313339,14945342,32.33,6.77
Tender_2592,5884714,3491485,370053,844612,332058,10922922,32.0,6.8
Tender_2593,6415913,4877237,1876532,992472,385752,14547906,15.0,8.5
Tender_2594,5879526,3290951,914015,538549,342549,10965590,51.67,4.83
Tender_2595,364472,3981991,1049417,752751,104662,6253293,42.67,5.73
Tender_2596,7401997,1574023,2760561,905890,480339,13122810,46.0,5.4
Tender_2597,2906790,4582495,2529436,478878,162628,10660227,32.67,6.73
Tender_2598,8345860,4849638,805108,345315,362431,14708352,36.0,6.4
Tender_2599,2259291,1249622,2741070,373041,345648,6968672,23.67,7.63
Tender_2600,9547675,3116753,2713731,731298,74561,16184018,31.67,6.83
Tender_2601,2270862,4173964,2342309,153102,469417,9409654,40.33,5.97
Tender_2602,1052169,3690748,741395,412464,110353,6007129,41.67,5.83
Tender_2603,6646088,3019541,2618093,918626,409546,13611894,29.33,7.07
Tender_2604,3553330,2887281,2250948,106396,282399,9080354,34.67,6.53
Tender_2605,1388383,2919221,435758,781405,318170,5842937,44.67,5.53
Tender_2606,9167310,654019,360796,924431,245888,11352444,40.0,6.0
Tender_2607,6344993,2308757,2261875,558548,220265,11694438,51.67,4.83
Tender_2608,4979875,3714554,1676563,697660,272003,11340655,57.0,4.3
Tender_2609,4825504,3128085,770838,756639,251080,9732146,31.0,6.9
Tender_2610,9314455,4340972,1173230,395420,223561,15447638,54.33,4.57
Tender_2611,1103335,2024274,926389,595620,288852,4938470,28.33,7.17
Tender_2612,7445920,646740,2280032,389788,131923,10894403,35.67,6.43
Tender_2613,6726203,2353208,140602,255524,69145,9544682,28.67,7.13
Tender_2614,7749092,1777757,2976825,201529,60924,12766127,27.67,7.23
Tender_2615,6598513,575319,449566,507101,286170,8416669,37.67,6.23
Tender_2616,4745356,2997327,439792,969898,420309,9572682,19.33,8.07
Tender_2617,7463184,2019448,2170820,455040,95696,12204188,52.33,4.77
Tender_2618,2551933,1427896,262299,186162,381099,4809389,47.33,5.27
Tender_2619,752862,962238,2922264,416358,483876,5537598,33.0,6.7
Tender_2620,7277339,4643159,867553,867805,463633,14119489,31.67,6.83
Tender_2621,5611939,4935788,2263484,231230,461779,13504220,37.33,6.27
Tender_2622,1253692,2088281,2830444,882876,132966,7188259,41.67,5.83
Tender_2623,6894551,988687,1698957,941769,446691,10970655,46.67,5.33
Tender_2624,6039494,3145312,1456109,633047,74217,11348179,36.67,6.33
Tender_2625,1632486,2185837,241327,543124,313970,4916744,35.0,6.5
Tender_2626,2420180,491943,904405,801940,86722,4705190,49.67,5.03
Tender_2627,6932109,2843815,200648,147276,170159,10294007,37.33,6.27
Tender_2628,5555544,4390220,1676595,499636,179069,12301064,45.67,5.43
Tender_2629,4395510,3292574,2716070,682178,410058,11496390,35.0,6.5
Tender_2630,8193431,3191699,1639564,772281,141456,13938431,29.0,7.1
Tender_2631,3503968,2305895,1746570,353545,198550,8108528,40.33,5.97
Tender_2632,8294625,4662434,2781967,320877,109746,16169649,33.33,6.67
Tender_2633,824494,1850834,1460454,997306,478229,5611317,30.33,6.97
Tender_2634,4773009,2038949,2789440,318653,129290,10049341,37.0,6.3
Tender_2635,2956232,4321033,1482857,223651,217880,9201653,55.33,4.47
Tender_2636,1284430,4812270,2131770,731236,199501,9159207,22.33,7.77
Tender_2637,5289577,472987,1474494,714027,346743,8297828,43.67,5.63
Tender_2638,2201641,3667043,459680,320114,272776,6921254,28.67,7.13
Tender_2639,6295516,4289618,2374560,677141,52429,13689264,20.33,7.97
Tender_2640,2623445,1013241,1135872,633343,100083,5505984,45.0,5.5
Tender_2641,4152381,970083,605826,556873,429361,6714524,61.0,3.9
Tender_2642,9510022,4234358,893664,652099,158370,15448513,44.0,5.6
Tender_2643,7747255,2487767,2255062,486753,175831,13152668,49.33,5.07
Tender_2644,7556914,1554881,2724565,298034,211551,12345945,42.67,5.73
Tender_2645,9068415,3150801,406573,397490,331046,13354325,47.67,5.23
Tender_2646,8467697,791152,1336709,558039,446115,11599712,44.33,5.57
Tender_2647,1197631,4406530,2636527,592161,241839,9074688,51.33,4.87
Tender_2648,650822,3674975,146325,350007,454634,5276763,23.0,7.7
Tender_2649,304639,4011425,108511,452338,404050,5280963,25.33,7.47
Tender_2650,9720926,2852649,1738683,117043,149501,14578802,31.67,6.83
Tender_2651,9087167,3550481,1746397,156497,254826,14795368,50.0,5.0
Tender_2652,5922694,3271483,1783583,844369,325348,12147477,42.67,5.73
Tender_2653,4748113,4078354,1065218,991557,102349,10985591,34.67,6.53
Tender_2654,6003023,948935,628762,258362,347251,8186333,49.67,5.03
Tender_2655,1139646,3892374,596050,605703,449958,6683731,41.67,5.83
Tender_2656,7025688,3157373,1589372,322617,474868,12569918,35.33,6.47
Tender_2657,3641747,1150337,2328359,378167,80151,7578761,43.67,5.63
Tender_2658,5912894,2618402,509713,963742,355838,10360589,48.0,5.2
Tender_2659,8166058,482933,1878997,142662,331294,11001944,39.33,6.07
Tender_2660,6885258,3932782,69940,794397,307196,11989573,37.67,6.23
Tender_2661,4229819,3041268,589055,248148,475229,8583519,56.67,4.33
Tender_2662,3672131,4436864,680563,981083,289957,10060598,28.33,7.17
Tender_2663,8839556,3257125,919077,896934,480934,14393626,31.33,6.87
Tender_2664,2165339,1006436,2049508,877212,273646,6372141,50.67,4.93
Tender_2665,3323718,2168033,2115328,55652,298052,7960783,32.33,6.77
Tender_2666,3457369,4828214,2491235,980599,201135,11958552,28.0,7.2
Tender_2667,5635245,2030020,2677804,834717,347504,11525290,47.33,5.27
Tender_2668,5184467,2394788,2490635,189624,266547,10526061,41.33,5.87
Tender_2669,3448012,4046819,1157691,682856,287034,9622412,46.67,5.33
Tender_2670,3793100,2280389,1530752,752468,93495,8450204,23.0,7.7
Tender_2671,7417003,4971180,293395,696975,347327,13725880,34.0,6.6
Tender_2672,983213,3153721,1572441,867932,426264,7003571,34.67,6.53
Tender_2673,6790298,457114,1122271,653772,418222,9441677,32.33,6.77
Tender_2674,2793296,507428,2958031,79554,186367,6524676,41.67,5.83
Tender_2675,295766,2592140,2523793,296121,448471,6156291,30.67,6.93
Tender_2676,3665261,2665460,1532207,75425,310441,8248794,50.33,4.97
Tender_2677,8478743,637887,748737,264259,487315,10616941,33.0,6.7
Tender_2678,7127065,4625967,689547,831075,97726,13371380,45.67,5.43
Tender_2679,1141367,3103067,600915,837069,125938,5808356,35.67,6.43
Tender_2680,2371729,569933,1111536,781308,241959,5076465,42.33,5.77
Tender_2681,854617,181398,2692425,805591,496242,5030273,37.67,6.23
Tender_2682,8556707,3699522,2454697,750114,471985,15933025,51.67,4.83
Tender_2683,737879,404568,2360924,550410,71869,4125650,31.33,6.87
Tender_2684,7677247,1724435,2861084,190723,413474,12866963,49.0,5.1
Tender_2685,4335364,166251,1677812,77486,350245,6607158,34.67,6.53
Tender_2686,8082311,4282870,1991458,688863,177455,15222957,26.0,7.4
Tender_2687,4181521,4456429,2641711,432524,297589,12009774,40.67,5.93
Tender_2688,6837161,2676835,2777113,484665,81565,12857339,31.0,6.9
Tender_2689,7234234,2100471,1354537,965296,469226,12123764,34.0,6.6
Tender_2690,9210698,3257831,720930,214162,70034,13473655,45.33,5.47
Tender_2691,927312,2051207,643347,414350,366543,4402759,52.33,4.77
Tender_2692,4259021,2419630,97951,900198,105756,7782556,35.67,6.43
Tender_2693,1719516,4514183,1565941,80937,92982,7973559,23.0,7.7
Tender_2694,7487492,3450917,2923682,947804,110387,14920282,37.67,6.23
Tender_2695,7619335,792359,2169095,418612,263604,11263005,36.33,6.37
Tender_2696,7504806,2804721,1495709,572049,432692,12809977,47.33,5.27
Tender_2697,472507,3693873,2417828,433757,215505,7233470,38.0,6.2
Tender_2698,7730279,2783476,756940,715426,153628,12139749,37.67,6.23
Tender_2699,436755,4674672,2112204,198628,466795,7889054,30.0,7.0
Tender_2700,4705670,4384326,2020029,170751,299506,11580282,41.67,5.83
Tender_2701,6650485,4072958,1513004,323723,300700,12860870,36.33,6.37
Tender_2702,7440459,1719217,551946,645933,222479,10580034,31.0,6.9
Tender_2703,565843,2549554,1023513,552172,198656,4889738,36.33,6.37
Tender_2704,943782,359903,75508,321122,269756,1970071,38.33,6.17
Tender_2705,5847948,2254129,2748978,921484,140779,11913318,31.67,6.83
Tender_2706,5824353,4747821,2534096,193340,342671,13642281,25.33,7.47
Tender_2707,4167217,3401268,2836405,115902,207796,10728588,25.0,7.5
Tender_2708,1287383,2181018,1061516,99607,70725,4700249,24.0,7.6
Tender_2709,9996558,4653050,2880174,493104,257248,18280134,50.33,4.97
Tender_2710,9919089,2319708,2083957,744787,105293,15172834,40.33,5.97
Tender_2711,4873495,699344,1015566,887017,252188,7727610,32.33,6.77
Tender_2712,9824779,1776169,687413,496585,396326,13181272,37.67,6.23
Tender_2713,3356854,4082513,2420736,342610,157733,10360446,41.0,5.9
Tender_2714,4792330,238058,2031119,459298,433070,7953875,43.67,5.63
Tender_2715,4701206,3811516,747598,540186,146488,9946994,22.0,7.8
Tender_2716,1332804,4476150,2422774,500071,421641,9153440,44.67,5.53
Tender_2717,6722341,4047928,421762,295496,460902,11948429,37.0,6.3
Tender_2718,1633132,341366,1303466,509786,438010,4225760,32.67,6.73
Tender_2719,6306750,2020464,311218,921648,313693,9873773,28.67,7.13
Tender_2720,932279,1694308,813312,464958,158204,4063061,39.0,6.1
Tender_2721,3332898,533035,2850768,86727,351447,7154875,28.67,7.13
Tender_2722,9585544,833416,676864,541413,266868,11904105,23.33,7.67
Tender_2723,7559938,2445797,1881838,458578,307193,12653344,33.0,6.7
Tender_2724,9618458,655525,2177825,857451,283223,13592482,40.33,5.97
Tender_2725,2752325,1040705,181640,855211,242775,5072656,41.33,5.87
Tender_2726,7187851,4347573,2313028,67396,409546,14325394,47.33,5.27
Tender_2727,3100029,1357164,557313,504364,480089,5998959,25.67,7.43
Tender_2728,2538727,3351157,1259841,786197,473764,8409686,36.33,6.37
Tender_2729,5642853,573771,1721080,694985,310417,8943106,39.0,6.1
Tender_2730,5842583,3719076,1086131,357101,147403,11152294,33.33,6.67
Tender_2731,5789355,463259,1399042,190120,368802,8210578,41.67,5.83
Tender_2732,7673590,3358694,1433791,115009,332506,12913590,45.33,5.47
Tender_2733,5311076,4523912,122350,776011,238006,10971355,21.67,7.83
Tender_2734,2000224,1502061,1711317,189580,183319,5586501,38.33,6.17
Tender_2735,4576779,778236,2777769,209645,58316,8400745,19.0,8.1
Tender_2736,5984803,4074534,1849721,824786,293568,13027412,21.67,7.83
Tender_2737,929297,3799775,1833458,967401,396224,7926155,35.0,6.5
Tender_2738,8946659,3619721,2672813,888172,107982,16235347,41.67,5.83
Tender_2739,840753,2392942,2721003,242390,206292,6403380,44.67,5.53
Tender_2740,7479029,3449599,1378851,732216,350625,13390320,48.67,5.13
Tender_2741,6639687,4292706,1237878,956819,419170,13546260,26.33,7.37
Tender_2742,620029,269766,245207,411539,357991,1904532,42.67,5.73
Tender_2743,4094603,2976824,2075455,873404,435109,10455395,30.67,6.93
Tender_2744,7172358,4272690,2518432,614411,91637,14669528,41.0,5.9
Tender_2745,4108072,2603230,534353,601315,341160,8188130,31.67,6.83
Tender_2746,4656775,1516540,1064644,436614,368046,8042619,39.67,6.03
Tender_2747,421520,101314,2804935,181111,404856,3913736,39.33,6.07
Tender_2748,9965977,2986740,1985783,705845,102635,15746980,33.33,6.67
Tender_2749,1677750,376948,161221,292236,277703,2785858,31.67,6.83
Tender_2750,6586839,613458,1454103,632952,133128,9420480,33.67,6.63
Tender_2751,1511284,4571732,2020960,338491,98959,8541426,35.0,6.5
Tender_2752,7180008,415366,2683663,179799,240863,10699699,49.33,5.07
Tender_2753,9691706,177768,512180,444602,130443,10956699,35.0,6.5
Tender_2754,3861217,405181,555419,795115,365331,5982263,37.33,6.27
Tender_2755,2269191,625608,1019615,350373,461122,4725909,31.33,6.87
Tender_2756,4316624,4532167,745737,640741,173919,10409188,33.0,6.7
Tender_2757,3516248,1375408,1910612,980145,324985,8107398,44.0,5.6
Tender_2758,4367757,3609401,2780533,520229,403458,11681378,42.0,5.8
Tender_2759,6536625,133188,2885143,653399,127914,10336269,48.33,5.17
Tender_2760,3567687,3450415,749770,628474,168025,8564371,44.33,5.57
Tender_2761,5090270,1652576,1031327,730189,464948,8969310,53.33,4.67
Tender_2762,5616692,621838,1386423,372224,466933,8464110,35.33,6.47
Tender_2763,3095267,1088973,1827749,553527,400469,6965985,41.0,5.9
Tender_2764,9160569,1120184,1776352,715236,495056,13267397,20.33,7.97
Tender_2765,721022,165783,738580,318930,102729,2047044,39.33,6.07
Tender_2766,4709274,3315531,2696827,79837,213342,11014811,46.0,5.4
Tender_2767,3883764,4597190,1417199,169948,83620,10151721,38.33,6.17
Tender_2768,3368603,4781394,1982684,635014,433533,11201228,42.33,5.77
Tender_2769,3184843,4126942,2391983,114020,52158,9869946,46.67,5.33
Tender_2770,6680098,139109,939947,557218,201083,8517455,41.33,5.87
Tender_2771,4524370,436644,827833,478596,388498,6655941,39.0,6.1
Tender_2772,4853346,4985992,334855,595926,254054,11024173,46.0,5.4
Tender_2773,4677365,554252,1642170,169915,333874,7377576,49.33,5.07
Tender_2774,6482883,2682679,2265290,290405,284559,12005816,31.33,6.87
Tender_2775,8768069,1469311,1252813,70452,106350,11666995,23.0,7.7
Tender_2776,1799276,2163262,1231604,776665,233615,6204422,47.33,5.27
Tender_2777,6998635,1355510,1513350,835934,451903,11155332,55.67,4.43
Tender_2778,5266381,3529337,1695745,122159,267798,10881420,43.33,5.67
Tender_2779,4786464,3570273,1416710,991816,97224,10862487,35.33,6.47
Tender_2780,7176146,1973922,1412921,879147,125186,11567322,42.67,5.73
Tender_2781,1809528,2454541,703631,54444,147771,5169915,54.33,4.57
Tender_2782,5708015,3029093,269138,294767,53229,9354242,45.67,5.43
Tender_2783,2852392,3463107,460580,392451,272943,7441473,27.67,7.23
Tender_2784,8661441,2689439,869314,457576,275068,12952838,47.33,5.27
Tender_2785,7080466,2942430,884392,761350,426230,12094868,40.0,6.0
Tender_2786,9453910,399894,768429,139208,285143,11046584,47.67,5.23
Tender_2787,2102512,2324516,58630,325920,88965,4900543,38.0,6.2
Tender_2788,5700483,379519,1582725,678319,218301,8559347,26.33,7.37
Tender_2789,2033944,4115771,2103569,961173,242649,9457106,38.0,6.2
Tender_2790,6267364,2562504,903006,824389,407950,10965213,27.67,7.23
Tender_2791,7123648,1335782,2013878,706484,244826,11424618,26.33,7.37
Tender_2792,8023666,3045891,493456,729443,258409,12550865,31.0,6.9
Tender_2793,5261034,1285872,2979729,716963,228289,10471887,43.0,5.7
Tender_2794,505603,1155102,2469281,761293,57493,4948772,37.0,6.3
Tender_2795,8365807,228725,1224061,315590,186657,10320840,50.67,4.93
Tender_2796,4432811,1496892,219579,814242,398422,7361946,41.0,5.9
Tender_2797,9782320,625099,778348,998116,250816,12434699,31.0,6.9
Tender_2798,1802147,2010237,184242,972985,281777,5251388,41.0,5.9
Tender_2799,7563017,2840925,2111866,681394,251215,13448417,46.67,5.33
Tender_2800,689675,1192440,518389,225238,241139,2866881,26.0,7.4
Tender_2801,7306560,317801,798518,249199,479330,9151408,42.33,5.77
Tender_2802,475412,4062825,2065726,467927,228061,7299951,28.67,7.13
Tender_2803,9304965,3568282,2025572,173300,69082,15141201,28.0,7.2
Tender_2804,1863726,2297773,2131648,177072,230803,6701022,22.0,7.8
Tender_2805,2534915,2183586,533391,989792,492008,6733692,41.67,5.83
Tender_2806,5971216,2982710,2658908,891957,279172,12783963,24.0,7.6
Tender_2807,7576102,4863470,420551,733156,77484,13670763,44.67,5.53
Tender_2808,1241392,1913553,291802,496167,230047,4172961,46.33,5.37
Tender_2809,6791997,1375161,461826,532232,417988,9579204,26.33,7.37
Tender_2810,714210,3164462,1846058,559140,292540,6576410,40.67,5.93
Tender_2811,2805682,3624277,1112971,873010,120050,8535990,34.0,6.6
Tender_2812,9108346,1125765,2779784,322400,164002,13500297,43.67,5.63
Tender_2813,2979539,4375346,1686435,519865,247976,9809161,49.0,5.1
Tender_2814,2681171,1796108,228206,899404,385084,5989973,40.33,5.97
Tender_2815,4655064,4040546,2267844,539971,198550,11701975,43.33,5.67
Tender_2816,9427438,435787,644921,268634,300689,11077469,34.67,6.53
Tender_2817,7546426,1142784,2810020,123796,210304,11833330,34.67,6.53
Tender_2818,1322883,2975333,2305048,283235,341005,7227504,30.67,6.93
Tender_2819,5435802,3909246,633004,720499,177035,10875586,33.0,6.7
Tender_2820,8185261,4129999,518508,274797,50766,13159331,31.33,6.87
Tender_2821,1062758,2667189,2880953,330774,371335,7313009,48.33,5.17
Tender_2822,7074313,2707767,2615447,801870,116483,13315880,24.0,7.6
Tender_2823,8390563,815172,755548,148313,345711,10455307,46.0,5.4
Tender_2824,6061647,3638912,1916249,158300,55649,11830757,28.0,7.2
Tender_2825,6785997,3654266,635503,554959,301939,11932664,45.0,5.5
Tender_2826,5725365,1376213,1691544,882179,480794,10156095,26.0,7.4
Tender_2827,752303,1081715,1529945,940933,271273,4576169,36.33,6.37
Tender_2828,506699,2502129,2819936,98087,302179,6229030,25.33,7.47
Tender_2829,516876,2831303,1982740,203533,92270,5626722,29.67,7.03
Tender_2830,3262916,4828962,1458955,904301,417022,10872156,26.67,7.33
Tender_2831,2098499,4416640,1574364,539832,207010,8836345,47.33,5.27
Tender_2832,9749573,2665899,775393,190863,415320,13797048,27.33,7.27
Tender_2833,7763582,4438498,2608130,642892,423274,15876376,47.0,5.3
Tender_2834,7678537,2358288,1097839,807099,279353,12221116,31.0,6.9
Tender_2835,7270396,4125260,2733320,825702,132907,15087585,32.67,6.73
Tender_2836,5290715,764910,799692,311857,154677,7321851,45.0,5.5
Tender_2837,7664409,3676434,2102324,398849,219808,14061824,36.33,6.37
Tender_2838,317465,4902841,1857725,817052,105788,8000871,36.33,6.37
Tender_2839,5405651,1974219,2122481,417262,110281,10029894,46.67,5.33
Tender_2840,9541166,3633838,1047923,648168,386336,15257431,51.67,4.83
Tender_2841,7072579,920977,914939,545911,459297,9913703,20.0,8.0
Tender_2842,681747,4242300,2693089,304323,420668,8342127,52.67,4.73
Tender_2843,1576792,2800843,217746,212217,450988,5258586,28.0,7.2
Tender_2844,6969798,3250652,737393,864236,318715,12140794,32.33,6.77
Tender_2845,5925780,4740330,787150,770760,132829,12356849,38.33,6.17
Tender_2846,6883349,1532037,2431501,581235,393818,11821940,45.33,5.47
Tender_2847,1363404,3451276,845942,840539,415550,6916711,37.0,6.3
Tender_2848,2577454,4586515,51328,466545,138042,7819884,42.0,5.8
Tender_2849,5407688,636977,2361595,625650,139519,9171429,27.33,7.27
Tender_2850,7521917,2266314,1264431,936855,191579,12181096,42.0,5.8
Tender_2851,7107630,1082015,2318339,557262,336577,11401823,33.67,6.63
Tender_2852,2456649,3170417,1474872,117738,338758,7558434,46.33,5.37
Tender_2853,5774040,2854847,427602,545483,212684,9814656,34.67,6.53
Tender_2854,7115923,347676,2915156,735493,464232,11578480,29.0,7.1
Tender_2855,9964644,821634,424141,572970,229212,12012601,34.67,6.53
Tender_2856,6018682,2578134,387551,378456,330250,9693073,32.33,6.77
Tender_2857,1277932,2912705,1739373,848389,112032,6890431,48.67,5.13
Tender_2858,2560771,3918938,171631,109969,361742,7123051,48.33,5.17
Tender_2859,6436090,216388,2214041,242909,452639,9562067,34.33,6.57
Tender_2860,1315004,200954,2226950,898584,217360,4858852,41.33,5.87
Tender_2861,7279676,2465294,1630296,331013,403266,12109545,43.0,5.7
Tender_2862,2473027,237086,2758796,580227,144521,6193657,36.33,6.37
Tender_2863,8620505,887654,591000,253149,282583,10634891,36.0,6.4
Tender_2864,693457,4169737,534515,679083,291193,6367985,41.67,5.83
Tender_2865,3136393,1690589,1870398,667528,108853,7473761,20.67,7.93
Tender_2866,6608817,2006466,1268326,170860,493210,10547679,39.33,6.07
Tender_2867,2032460,3940684,2607056,198292,89713,8868205,28.33,7.17
Tender_2868,4810105,2902661,1209613,89149,173171,9184699,43.0,5.7
Tender_2869,3203887,860192,789140,919504,89469,5862192,47.33,5.27
Tender_2870,2752564,965777,130901,469208,232119,4550569,37.33,6.27
Tender_2871,9022616,1529226,644680,753012,113916,12063450,29.0,7.1
Tender_2872,5105668,4522541,1916829,129966,428469,12103473,31.0,6.9
Tender_2873,8574084,3630231,2242798,759889,285437,15492439,32.0,6.8
Tender_2874,5015167,751778,347182,404002,277573,6795702,30.33,6.97
Tender_2875,6651329,2017990,2190242,405875,302865,11568301,33.33,6.67
Tender_2876,8365172,1103854,2943907,685027,312515,13410475,43.0,5.7
Tender_2877,8948714,4475674,975832,591838,336752,15328810,28.0,7.2
Tender_2878,5968326,4427181,835838,662361,127867,12021573,34.33,6.57
Tender_2879,2252252,1862899,1411645,830254,174790,6531840,35.33,6.47
Tender_2880,3730941,2944859,785390,246184,456434,8163808,35.67,6.43
Tender_2881,7284025,2862694,1359627,600816,237284,12344446,31.0,6.9
Tender_2882,9050972,3853155,1326940,270941,238804,14740812,23.0,7.7
Tender_2883,1435987,400652,2299054,525207,90705,4751605,42.0,5.8
Tender_2884,4798733,858711,1505771,818809,165302,8147326,40.0,6.0
Tender_2885,9253356,3622884,903503,878006,236482,14894231,33.67,6.63
Tender_2886,566998,340194,479425,539177,154208,2080002,28.33,7.17
Tender_2887,4813288,916051,2145108,952531,142955,8969933,55.67,4.43
Tender_2888,4672417,3683135,803558,422209,290562,9871881,34.67,6.53
Tender_2889,6510992,824576,1840253,239775,234535,9650131,49.67,5.03
Tender_2890,4091649,3204394,2369240,807948,359409,10832640,47.0,5.3
Tender_2891,5847758,4909077,603143,206840,123006,11689824,34.33,6.57
Tender_2892,9430855,2592649,390002,251910,166501,12831917,46.0,5.4
Tender_2893,854428,1521079,1519627,955951,233954,5085039,29.0,7.1
Tender_2894,914233,3015075,2755883,952333,91623,7729147,54.0,4.6
Tender_2895,2448873,2194052,2948530,415068,398961,8405484,46.33,5.37
Tender_2896,7752726,2825496,2968291,446112,373616,14366241,34.0,6.6
Tender_2897,2499351,1250988,1445315,424717,360671,5981042,43.33,5.67
Tender_2898,1769791,3129579,1765939,997899,199163,7862371,34.33,6.57
Tender_2899,7692769,2088107,2097163,982361,73118,12933518,51.67,4.83
Tender_2900,1907882,3873126,2797118,414023,166957,9159106,32.67,6.73
Tender_2901,4673119,215181,418388,135311,314158,5756157,49.67,5.03
Tender_2902,2286779,2621665,2482598,819437,82597,8293076,37.67,6.23
Tender_2903,1971866,1402928,608653,381366,370180,4734993,41.33,5.87
Tender_2904,2447172,341451,94149,868033,453447,4204252,44.67,5.53
Tender_2905,2032735,3355628,367928,178903,425307,6360501,45.33,5.47
Tender_2906,3229233,3098916,811770,642769,426888,8209576,44.33,5.57
Tender_2907,882375,2818210,1141898,198826,298735,5340044,44.67,5.53
Tender_2908,6015702,2451459,2148382,569619,471774,11656936,38.33,6.17
Tender_2909,8958429,2405126,1337507,724686,342303,13768051,41.33,5.87
Tender_2910,8624687,130575,1332883,395984,292728,10776857,47.67,5.23
Tender_2911,8644897,4707331,527874,868370,317618,15066090,50.67,4.93
Tender_2912,5087785,200873,1905579,777260,214460,8185957,53.0,4.7
Tender_2913,1332279,4981837,318197,344586,82919,7059818,40.33,5.97
Tender_2914,9989282,2759127,2782645,149284,394957,16075295,52.33,4.77
Tender_2915,3488095,4796060,1527381,905271,207059,10923866,51.33,4.87
Tender_2916,6756663,1405796,1253102,52217,396968,9864746,48.33,5.17
Tender_2917,3025285,4448773,1316818,492069,240209,9523154,49.0,5.1
Tender_2918,6492628,1275400,840282,558134,179485,9345929,38.33,6.17
Tender_2919,3730020,1067229,2507672,423451,401769,8130141,43.33,5.67
Tender_2920,1723591,2901672,1632541,589012,312779,7159595,36.0,6.4
Tender_2921,3917790,2672016,326814,421614,470457,7808691,32.67,6.73
Tender_2922,5256899,4958143,2293192,592950,342289,13443473,49.33,5.07
Tender_2923,4482148,3673985,2533779,838268,213937,11742117,38.67,6.13
Tender_2924,7313739,1686011,163837,606620,143881,9914088,33.67,6.63
Tender_2925,661093,197179,2101449,849676,319549,4128946,25.0,7.5
Tender_2926,8020568,4333443,2994574,290073,163108,15801766,28.67,7.13
Tender_2927,8792195,2073960,2337377,337978,327352,13868862,15.0,8.5
Tender_2928,1356902,4115785,848406,448818,249299,7019210,29.33,7.07
Tender_2929,8770508,4110993,331811,205638,471052,13890002,56.0,4.4
Tender_2930,2886124,1246910,1365485,393688,248741,6140948,30.33,6.97
Tender_2931,5864059,2942964,700219,776786,181522,10465550,40.0,6.0
Tender_2932,2347807,1051796,1049757,608106,387021,5444487,42.33,5.77
Tender_2933,2019908,4644756,1113391,103720,292407,8174182,40.67,5.93
Tender_2934,4161925,4301347,2416364,356640,61060,11297336,36.67,6.33
Tender_2935,9328613,2019312,2546485,168378,384244,14447032,31.0,6.9
Tender_2936,5947100,1722525,871172,661958,356723,9559478,38.0,6.2
Tender_2937,2946742,4803285,2922884,853603,316579,11843093,44.33,5.57
Tender_2938,2446969,2914550,2757866,963147,477156,9559688,44.33,5.57
Tender_2939,2987097,2145623,2774827,125191,266830,8299568,37.33,6.27
Tender_2940,3861432,2632265,2104008,121806,176106,8895617,39.67,6.03
Tender_2941,2240595,759310,634913,167409,271021,4073248,42.67,5.73
Tender_2942,1299098,384308,1779004,852453,499597,4814460,26.67,7.33
Tender_2943,5419406,1596172,2523152,471045,291895,10301670,35.0,6.5
Tender_2944,3307288,3359854,2568773,578826,352099,10166840,30.0,7.0
Tender_2945,3971144,1985676,1597006,998003,183249,8735078,25.33,7.47
Tender_2946,1530722,4676439,464547,635219,164389,7471316,39.33,6.07
Tender_2947,1530676,3602691,2471038,51380,148803,7804588,23.0,7.7
Tender_2948,6281481,2514340,2804841,241245,345741,12187648,29.0,7.1
Tender_2949,5414351,1938147,558326,859161,218300,8988285,17.67,8.23
Tender_2950,8305615,3188308,861222,577076,392637,13324858,44.67,5.53
Tender_2951,9964713,2571297,832942,172450,347036,13888438,32.0,6.8
Tender_2952,7785307,2264728,110421,234354,229459,10624269,38.67,6.13
Tender_2953,343235,4171796,1446893,394367,431751,6788042,42.33,5.77
Tender_2954,4521560,202125,2245081,663400,249701,7881867,38.67,6.13
Tender_2955,9788104,3853431,1409710,420736,194250,15666231,37.67,6.23
Tender_2956,9149005,2944903,946801,330797,127888,13499394,45.67,5.43
Tender_2957,8758686,2776282,2110631,228902,123798,13998299,33.0,6.7
Tender_2958,4019555,2535917,1149145,427269,169500,8301386,24.33,7.57
Tender_2959,1511311,3131640,2277971,102311,88945,7112178,43.33,5.67
Tender_2960,3118267,1698578,1576623,335630,208100,6937198,36.33,6.37
Tender_2961,490266,4574113,2211235,707792,203240,8186646,53.33,4.67
Tender_2962,6554561,4684977,257805,306711,354424,12158478,43.0,5.7
Tender_2963,797810,1528712,1150474,364915,71740,3913651,30.33,6.97
Tender_2964,5470423,1407018,2246583,358827,329452,9812303,50.33,4.97
Tender_2965,4058662,2122643,800732,191041,84078,7257156,48.67,5.13
Tender_2966,9973488,2377569,2687628,495078,292874,15826637,48.67,5.13
Tender_2967,5938909,353238,1985151,751873,143900,9173071,32.0,6.8
Tender_2968,5400234,4842445,1715673,181176,121974,12261502,36.0,6.4
Tender_2969,4301977,1112865,2731997,74016,475141,8695996,36.33,6.37
Tender_2970,3000518,3840522,1252693,335948,239838,8669519,39.0,6.1
Tender_2971,8829603,380308,668332,568095,320355,10766693,32.67,6.73
Tender_2972,4845210,4314225,869822,145132,80849,10255238,35.33,6.47
Tender_2973,6019330,4850537,2803123,804403,497634,14975027,25.67,7.43
Tender_2974,1484152,2789854,852069,935841,149339,6211255,38.67,6.13
Tender_2975,2382500,4170682,1760396,845782,434664,9594024,42.67,5.73
Tender_2976,9657174,2660732,2476227,352720,354060,15500913,34.0,6.6
Tender_2977,3707076,1883050,911341,950185,423975,7875627,42.67,5.73
Tender_2978,9188320,4513899,2410164,614156,307098,17033637,52.67,4.73
Tender_2979,7885611,1309702,66637,642134,119423,10023507,42.0,5.8
Tender_2980,8955234,3690561,2570645,84383,300909,15601732,42.67,5.73
Tender_2981,8763661,4270087,524691,582617,313072,14454128,38.0,6.2
Tender_2982,4735697,4535994,1303967,96787,107819,10780264,42.33,5.77
Tender_2983,3586788,1357380,2000599,318818,369846,7633431,27.0,7.3
Tender_2984,1486731,4793469,800577,939150,263165,8283092,46.0,5.4
Tender_2985,256298,1434126,151076,661621,145483,2648604,24.67,7.53
Tender_2986,7551862,3797983,94775,367552,161964,11974136,38.67,6.13
Tender_2987,5109155,3059008,2397523,831646,407643,11804975,59.0,4.1
Tender_2988,9794988,4970020,230522,527997,264181,15787708,37.33,6.27
Tender_2989,1545077,4457125,2647106,665944,478588,9793840,29.33,7.07
Tender_2990,4608395,3894516,379622,432713,204660,9519906,30.33,6.97
Tender_2991,9049978,3257254,623817,260763,349342,13541154,17.33,8.27
Tender_2992,7769219,4499251,1579401,361593,226699,14436163,36.67,6.33
Tender_2993,7155130,469056,1961331,295687,253723,10134927,52.33,4.77
Tender_2994,4916207,4007138,1005820,936043,364652,11229860,33.33,6.67
Tender_2995,3196260,4924566,2134439,297850,430426,10983541,37.0,6.3
Tender_2996,7612885,4750257,2714495,106513,97344,15281494,31.33,6.87
Tender_2997,3838955,674801,2294047,445160,294532,7547495,32.33,6.77
Tender_2998,275887,480640,762453,462543,216026,2197549,19.0,8.1
Tender_2999,302417,3086330,549740,493015,303764,4735266,40.0,6.0
Tender_3000,2999477,1122702,240938,474222,492799,5330138,55.0,4.5
Tender_3001,1075099,2038079,1432976,92446,314481,4953081,32.33,6.77
Tender_3002,1900717,1014106,1750804,340408,185568,5191603,34.67,6.53
Tender_3003,9144801,2673607,1976977,405467,416223,14617075,39.33,6.07
Tender_3004,9620010,3765151,2960440,864360,68514,17278475,52.33,4.77
Tender_3005,8354374,4985507,1024175,960980,93316,15418352,28.33,7.17
Tender_3006,1220612,1425012,935012,208348,157314,3946298,41.33,5.87
Tender_3007,7217290,4975421,2203918,839005,434088,15669722,35.0,6.5
Tender_3008,9328811,1937474,185954,292239,252519,11996997,39.0,6.1
Tender_3009,3506809,1805848,1810740,489583,274416,7887396,35.33,6.47
Tender_3010,2679193,4299338,1662644,804186,120052,9565413,41.67,5.83
Tender_3011,9775518,3260199,1441907,813737,128489,15419850,49.67,5.03
Tender_3012,2679117,1918521,574595,653277,79359,5904869,37.33,6.27
Tender_3013,4757804,2323117,1550823,191187,460151,9283082,46.33,5.37
Tender_3014,1137961,3103547,1777252,279028,273515,6571303,25.0,7.5
Tender_3015,1535899,4330551,2025131,608156,478606,8978343,44.0,5.6
Tender_3016,2130740,4172104,126336,219354,424612,7073146,28.0,7.2
Tender_3017,6531790,1524151,1488089,852290,428071,10824391,26.33,7.37
Tender_3018,3099266,1980388,1612040,222386,161081,7075161,31.67,6.83
Tender_3019,8752600,3326430,901546,88426,154465,13223467,48.33,5.17
Tender_3020,542050,2180976,1285451,950839,260841,5220157,53.0,4.7
Tender_3021,1673131,3246387,863824,969813,468386,7221541,50.0,5.0
Tender_3022,7170437,1358452,1366056,439721,65085,10399751,26.0,7.4
Tender_3023,9271131,4505050,1073345,62275,261016,15172817,27.33,7.27
Tender_3024,777766,2877495,1570523,241514,262488,5729786,18.33,8.17
Tender_3025,7990142,4316321,1721348,419725,69328,14516864,47.0,5.3
Tender_3026,4258503,2511752,1473952,934144,146054,9324405,39.33,6.07
Tender_3027,3081931,4670310,302132,881405,298542,9234320,37.0,6.3
Tender_3028,8899967,720242,634327,611769,228604,11094909,41.33,5.87
Tender_3029,1956396,987276,1828508,114422,365311,5251913,37.33,6.27
Tender_3030,9833988,2264196,2079317,207705,197373,14582579,44.67,5.53
Tender_3031,7980333,3224038,392359,635310,488755,12720795,48.33,5.17
Tender_3032,6353783,4185632,1385016,857793,431205,13213429,34.67,6.53
Tender_3033,736842,3128667,1066217,703334,230965,5866025,33.33,6.67
Tender_3034,7827309,4530027,1204207,324924,188848,14075315,34.0,6.6
Tender_3035,8433816,3951443,1368003,498972,472813,14725047,42.67,5.73
Tender_3036,2721790,1974146,1456961,834836,123765,7111498,24.33,7.57
Tender_3037,1444491,4560468,2066146,847845,234066,9153016,25.33,7.47
Tender_3038,8648755,3527996,1188371,625957,171627,14162706,49.33,5.07
Tender_3039,9537433,4677837,79097,254180,433303,14981850,51.0,4.9
Tender_3040,510356,4511923,1286524,991228,179193,7479224,37.67,6.23
Tender_3041,7428459,349464,1118299,82693,385240,9364155,43.33,5.67
Tender_3042,7233069,3178795,2474487,882586,480771,14249708,40.33,5.97
Tender_3043,6075496,506180,2643015,400953,430305,10055949,35.0,6.5
Tender_3044,1137871,3945868,717927,292348,311660,6405674,40.0,6.0
Tender_3045,5807448,2629585,2067101,548007,354136,11406277,31.33,6.87
Tender_3046,7341807,2726184,399113,915514,499037,11881655,37.33,6.27
Tender_3047,6267787,908674,332037,609019,343993,8461510,31.33,6.87
Tender_3048,6414435,1134062,237458,700111,63418,8549484,39.67,6.03
Tender_3049,4114781,2896268,2818061,374995,445408,10649513,41.67,5.83
Tender_3050,4890249,1593307,2199792,925821,217515,9826684,50.0,5.0
Tender_3051,585753,2560582,872873,68661,464701,4552570,52.33,4.77
Tender_3052,1041816,3980300,2071107,667011,179187,7939421,35.0,6.5
Tender_3053,2717534,723646,2424127,601041,68946,6535294,44.67,5.53
Tender_3054,7505603,4522269,311379,927485,477816,13744552,25.67,7.43
Tender_3055,8472832,3787354,2274117,890234,381412,15805949,41.33,5.87
Tender_3056,1585977,811879,1949970,492969,337248,5178043,34.33,6.57
Tender_3057,7112952,255914,2462287,492412,394734,10718299,40.67,5.93
Tender_3058,1352128,423627,2913935,579326,402362,5671378,43.33,5.67
Tender_3059,7826923,302795,2395311,172877,95064,10792970,49.0,5.1
Tender_3060,2461632,1764213,209364,684078,278228,5397515,30.0,7.0
Tender_3061,7873108,109660,1152565,610649,363953,10109935,30.33,6.97
Tender_3062,7665653,538586,327848,456911,214152,9203150,32.0,6.8
Tender_3063,5526947,2158510,2828635,340691,299947,11154730,38.67,6.13
Tender_3064,4126377,2960105,2228009,777174,380972,10472637,51.67,4.83
Tender_3065,9700259,1221237,1770241,597859,337044,13626640,49.0,5.1
Tender_3066,5754087,4083076,1578808,889903,284955,12590829,41.67,5.83
Tender_3067,4546599,2822786,1845870,854164,128459,10197878,38.33,6.17
Tender_3068,3723936,921767,1972305,497779,160307,7276094,26.33,7.37
Tender_3069,1770416,3990606,893208,869515,62191,7585936,32.33,6.77
Tender_3070,7376372,1549371,2348562,342632,290303,11907240,45.67,5.43
Tender_3071,1776828,4545403,1575917,745865,200985,8844998,47.0,5.3
Tender_3072,1434262,3393923,1854711,502931,213187,7399014,44.67,5.53
Tender_3073,9257598,1961108,1310278,505076,229457,13263517,41.0,5.9
Tender_3074,7031016,1181028,2843425,377783,394083,11827335,30.67,6.93
Tender_3075,8876860,2442949,2231015,646082,399658,14596564,50.0,5.0
Tender_3076,2061459,2665856,2344541,859389,368317,8299562,25.67,7.43
Tender_3077,4880994,4719364,287385,258906,313156,10459805,43.67,5.63
Tender_3078,3088583,4229979,152087,431501,154775,8056925,38.67,6.13
Tender_3079,2138187,4333157,544955,218444,74848,7309591,51.33,4.87
Tender_3080,8706822,2108596,2848865,310429,410625,14385337,35.0,6.5
Tender_3081,6409387,3658079,637332,597806,233983,11536587,35.33,6.47
Tender_3082,9872663,413617,1413020,432017,100784,12232101,42.67,5.73
Tender_3083,3224208,450093,1065526,555777,406660,5702264,31.0,6.9
Tender_3084,9705731,1337335,2616977,799129,121263,14580435,41.33,5.87
Tender_3085,4251070,4338108,196640,154586,144791,9085195,34.33,6.57
Tender_3086,1064803,2640000,1484588,966936,65141,6221468,29.67,7.03
Tender_3087,618126,3195093,964118,220879,260188,5258404,36.67,6.33
Tender_3088,5150310,3109816,833763,178119,149326,9421334,44.0,5.6
Tender_3089,4805559,4666475,511732,728660,329857,11042283,26.67,7.33
Tender_3090,2629140,1640472,1542443,213049,279602,6304706,39.0,6.1
Tender_3091,2830230,4328589,2555528,218153,80789,10013289,40.33,5.97
Tender_3092,9960845,693284,1656472,749272,287077,13346950,22.33,7.77
Tender_3093,4671612,2580525,869910,558838,396501,9077386,37.33,6.27
Tender_3094,7123927,3486880,1794321,973440,331502,13710070,46.67,5.33
Tender_3095,9452847,943836,170609,55888,95882,10719062,30.0,7.0
Tender_3096,8054527,4005560,1278294,173355,231820,13743556,31.33,6.87
Tender_3097,6927959,1505059,51733,155090,364423,9004264,32.0,6.8
Tender_3098,1910426,4039209,2956119,648292,147974,9702020,56.33,4.37
Tender_3099,7039559,360524,593666,194995,90958,8279702,44.0,5.6
Tender_3100,7097167,800304,1248197,727678,325595,10198941,34.33,6.57
Tender_3101,2291408,4760834,1509227,719227,112030,9392726,22.0,7.8
Tender_3102,2154327,4879847,407000,286180,247396,7974750,20.67,7.93
Tender_3103,9184005,1078948,2071903,839392,363007,13537255,30.0,7.0
Tender_3104,6443668,1858545,405870,405635,493591,9607309,37.0,6.3
Tender_3105,7974044,4412674,2534934,516646,486184,15924482,28.0,7.2
Tender_3106,809166,4777850,1296822,299470,295975,7479283,31.67,6.83
Tender_3107,1029670,4249966,2438900,558882,469314,8746732,34.0,6.6
Tender_3108,1769329,1149959,1202957,738758,302834,5163837,36.0,6.4
Tender_3109,541202,1050500,1383796,799954,225027,4000479,31.33,6.87
Tender_3110,9822276,4164078,601014,819444,120498,15527310,49.33,5.07
Tender_3111,2831910,1199674,2155683,891748,449797,7528812,44.67,5.53
Tender_3112,1204551,4640936,1040131,270969,393221,7549808,45.33,5.47
Tender_3113,8172616,2157923,377039,675930,465561,11849069,41.67,5.83
Tender_3114,4074097,3478731,1430742,293259,246264,9523093,23.0,7.7
Tender_3115,7634123,117208,1009857,997384,380943,10139515,37.33,6.27
Tender_3116,9453749,3737569,1057135,245834,283483,14777770,34.0,6.6
Tender_3117,7526064,3287184,2156547,439091,197472,13606358,28.67,7.13
Tender_3118,6938589,3642946,2543544,850353,258703,14234135,33.0,6.7
Tender_3119,5595717,4620288,1774900,763387,490488,13244780,27.33,7.27
Tender_3120,6223403,4339304,96619,90871,469753,11219950,45.33,5.47
Tender_3121,8141429,2392796,488276,127796,189222,11339519,29.0,7.1
Tender_3122,2134324,2207427,2858810,921263,94806,8216630,41.67,5.83
Tender_3123,5836572,4676085,185660,919927,238148,11856392,34.0,6.6
Tender_3124,5759242,4235059,1622021,688558,294861,12599741,29.33,7.07
Tender_3125,8295558,2514145,778708,231560,182433,12002404,38.0,6.2
Tender_3126,2970430,2133336,2355235,215321,333039,8007361,41.67,5.83
Tender_3127,9712694,829877,575406,548233,56843,11723053,31.33,6.87
Tender_3128,918550,3890829,836401,741330,312589,6699699,42.67,5.73
Tender_3129,3403033,1722929,1893744,149343,251060,7420109,42.67,5.73
Tender_3130,4651598,1758460,2840140,652654,250754,10153606,40.0,6.0
Tender_3131,1360823,1222745,1404614,499714,151601,4639497,32.33,6.77
Tender_3132,4053208,1190006,891550,989215,93603,7217582,40.67,5.93
Tender_3133,9367181,344160,1207184,833722,276180,12028427,41.67,5.83
Tender_3134,7216978,3521806,2425624,544570,426122,14135100,35.33,6.47
Tender_3135,5460335,1574081,2949047,929677,200059,11113199,32.33,6.77
Tender_3136,1404766,2438295,1413337,958687,327485,6542570,31.0,6.9
Tender_3137,7983966,4744298,2222856,727878,377838,16056836,43.0,5.7
Tender_3138,6655071,358511,2856784,808194,445075,11123635,42.33,5.77
Tender_3139,8530161,3989091,2075857,63937,365751,15024797,36.67,6.33
Tender_3140,4059714,1444791,1542768,285797,399605,7732675,40.0,6.0
Tender_3141,8210663,3929131,1792680,175755,241425,14349654,46.0,5.4
Tender_3142,2693673,2484720,2005649,63008,370250,7617300,30.67,6.93
Tender_3143,8337831,1919406,1345502,392483,493295,12488517,45.33,5.47
Tender_3144,3057396,2917527,2827677,875563,169282,9847445,39.0,6.1
Tender_3145,5980320,4378024,1343842,261576,228547,12192309,36.67,6.33
Tender_3146,676798,3148043,2728442,806562,171123,7530968,35.67,6.43
Tender_3147,6882615,3326159,961127,568232,263777,12001910,34.0,6.6
Tender_3148,3410085,4887176,1739805,173549,113807,10324422,43.33,5.67
Tender_3149,5976060,1873594,922557,856650,472221,10101082,41.67,5.83
Tender_3150,3874777,1169268,709284,604826,492504,6850659,45.33,5.47
Tender_3151,2229578,4316800,805439,86400,480194,7918411,45.33,5.47
Tender_3152,2824667,4203823,1398438,670654,80643,9178225,33.0,6.7
Tender_3153,2167162,2328040,141583,604395,179056,5420236,40.0,6.0
Tender_3154,6237208,2161323,991586,204610,328947,9923674,31.67,6.83
Tender_3155,1446378,2529571,655863,71725,281818,4985355,32.33,6.77
Tender_3156,980294,1247994,2946927,967030,208298,6350543,52.0,4.8
Tender_3157,708916,538037,1263236,379456,338767,3228412,27.67,7.23
Tender_3158,2016131,2874105,1712996,962280,286204,7851716,43.33,5.67
Tender_3159,3130351,241044,1947959,309783,102053,5731190,51.67,4.83
Tender_3160,9042468,1466039,2053668,739087,254679,13555941,39.67,6.03
Tender_3161,3249053,2500515,2199325,253091,185050,8387034,23.67,7.63
Tender_3162,4786253,564407,571027,529517,206441,6657645,31.0,6.9
Tender_3163,8970838,4993683,2146748,981456,232072,17324797,49.0,5.1
Tender_3164,7456728,143394,2688400,758986,259487,11306995,29.33,7.07
Tender_3165,1776495,3061260,2803411,981982,405180,9028328,44.67,5.53
Tender_3166,3857567,444382,992800,567230,371948,6233927,31.67,6.83
Tender_3167,1598174,4791150,577693,402090,65116,7434223,36.33,6.37
Tender_3168,1826203,1868354,577401,280145,485740,5037843,43.67,5.63
Tender_3169,201684,2491958,1717596,130454,123828,4665520,37.33,6.27
Tender_3170,3388687,3018241,1594037,212894,79557,8293416,42.33,5.77
Tender_3171,5674580,576857,2048881,603746,71167,8975231,33.0,6.7
Tender_3172,8921816,1743981,390123,339118,465364,11860402,39.33,6.07
Tender_3173,640560,3890106,383435,921259,222582,6057942,41.33,5.87
Tender_3174,7826760,2055461,1290443,518552,158937,11850153,25.33,7.47
Tender_3175,8004797,3229277,377957,821427,178191,12611649,48.0,5.2
Tender_3176,1634696,203720,2212531,673251,111392,4835590,35.33,6.47
Tender_3177,1150731,1607053,2080516,315136,271330,5424766,41.0,5.9
Tender_3178,1747487,3321159,922989,307520,198514,6497669,32.67,6.73
Tender_3179,2986411,4867119,1290049,281810,55936,9481325,26.0,7.4
Tender_3180,1170853,1547423,2937619,136559,412652,6205106,35.0,6.5
Tender_3181,4457395,2977077,2125001,432845,77114,10069432,25.33,7.47
Tender_3182,5928458,1458781,1960369,835542,481774,10664924,30.0,7.0
Tender_3183,9936870,3672593,2004086,705503,466265,16785317,30.33,6.97
Tender_3184,4051410,669785,2211593,198917,295021,7426726,41.0,5.9
Tender_3185,8779602,4057028,1337234,134475,479981,14788320,35.33,6.47
Tender_3186,8181604,3216433,685066,474221,349504,12906828,35.33,6.47
Tender_3187,6239443,801596,1644502,505183,421214,9611938,43.67,5.63
Tender_3188,6518541,3174469,1369387,319802,252294,11634493,48.67,5.13
Tender_3189,3987859,2242891,2483301,770035,244417,9728503,30.33,6.97
Tender_3190,8952724,828671,1985943,316176,319437,12402951,24.33,7.57
Tender_3191,5275986,4488429,2573731,818394,345420,13501960,45.33,5.47
Tender_3192,5606015,4664126,2228694,349768,84380,12932983,43.67,5.63
Tender_3193,4392051,1240383,1348294,931289,202558,8114575,42.0,5.8
Tender_3194,5664782,1591178,1002226,404719,345667,9008572,57.33,4.27
Tender_3195,4823813,4355259,1639563,822356,284832,11925823,26.0,7.4
Tender_3196,6759157,3887898,788986,61807,255406,11753254,37.67,6.23
Tender_3197,9374432,368430,194114,719113,240931,10897020,40.67,5.93
Tender_3198,2104087,561982,339351,538825,409748,3953993,34.0,6.6
Tender_3199,7201907,1297798,2053019,756275,91859,11400858,35.33,6.47
Tender_3200,6646883,668869,460209,319649,345850,8441460,43.67,5.63
Tender_3201,3102376,1926133,2872414,245948,50283,8197154,38.0,6.2
Tender_3202,3424205,3701058,522708,962509,424480,9034960,39.0,6.1
Tender_3203,993038,837592,362982,129112,102369,2425093,41.33,5.87
Tender_3204,351855,1912510,1125465,550289,300670,4240789,42.67,5.73
Tender_3205,3395693,4953439,831428,591880,193809,9966249,30.67,6.93
Tender_3206,7644082,4865199,1086315,572897,351248,14519741,34.0,6.6
Tender_3207,4110352,1527579,290431,593981,363539,6885882,50.33,4.97
Tender_3208,6759079,1847892,2394699,810939,384618,12197227,25.0,7.5
Tender_3209,3499209,1400011,341012,287944,165103,5693279,47.67,5.23
Tender_3210,8010662,1914684,2384741,78731,320373,12709191,39.0,6.1
Tender_3211,5972430,4335182,1010454,101979,148467,11568512,45.67,5.43
Tender_3212,8226242,3826565,2766883,411201,292657,15523548,35.0,6.5
Tender_3213,800923,2449885,1939073,544525,355356,6089762,36.0,6.4
Tender_3214,8892794,2529195,659932,422848,284741,12789510,32.67,6.73
Tender_3215,1370414,2853724,1643582,229672,313751,6411143,33.0,6.7
Tender_3216,5756977,895768,302899,893734,230591,8079969,30.67,6.93
Tender_3217,1269387,1446642,2800431,401486,298103,6216049,24.33,7.57
Tender_3218,9227924,1328582,1030648,570413,408255,12565822,57.0,4.3
Tender_3219,406123,4018567,1321348,435568,64543,6246149,47.67,5.23
Tender_3220,7840227,3627203,1726200,767321,484868,14445819,58.33,4.17
Tender_3221,8505102,122171,874273,587065,312190,10400801,44.33,5.57
Tender_3222,9273882,3881423,569620,250682,185881,14161488,45.67,5.43
Tender_3223,3997474,4581500,1950221,448480,302034,11279709,26.67,7.33
Tender_3224,3794098,3614508,2209832,347565,79080,10045083,34.67,6.53
Tender_3225,7360055,3701197,2624985,684701,279413,14650351,53.33,4.67
Tender_3226,9032061,162903,61773,763385,348032,10368154,24.67,7.53
Tender_3227,3305055,3849858,811059,886218,283537,9135727,39.0,6.1
Tender_3228,7086605,3483685,1089347,190998,285914,12136549,36.33,6.37
Tender_3229,1270459,2538132,1744634,632274,425920,6611419,42.67,5.73
Tender_3230,5076514,2521155,2108232,800188,493024,10999113,23.0,7.7
Tender_3231,5281067,1165053,1066720,684584,80125,8277549,35.0,6.5
Tender_3232,6852580,129274,2701915,466311,63270,10213350,34.0,6.6
Tender_3233,4633694,3907241,2531811,908874,205405,12187025,27.33,7.27
Tender_3234,6162108,415303,1829904,472336,125989,9005640,35.33,6.47
Tender_3235,6313524,4241710,981012,969386,472191,12977823,27.0,7.3
Tender_3236,7719887,4203419,1876709,837562,234676,14872253,51.67,4.83
Tender_3237,6081064,963426,2479490,867201,402253,10793434,42.67,5.73
Tender_3238,3927188,2039725,2480502,634973,131376,9213764,48.0,5.2
Tender_3239,1316451,3208981,1842984,131714,293280,6793410,43.67,5.63
Tender_3240,1233582,4904061,2600365,58504,435709,9232221,45.67,5.43
Tender_3241,936774,1408404,562356,943744,250673,4101951,37.67,6.23
Tender_3242,2480392,2068641,1900186,504075,374174,7327468,36.33,6.37
Tender_3243,7082216,2170032,2361945,736307,245988,12596488,43.0,5.7
Tender_3244,7379052,838431,1936251,290092,355508,10799334,39.33,6.07
Tender_3245,9573387,1567447,201818,58593,415136,11816381,29.33,7.07
Tender_3246,7639666,4690047,121994,68230,454224,12974161,45.0,5.5
Tender_3247,5397865,4994395,476898,554197,219500,11642855,41.67,5.83
Tender_3248,3264668,4297315,1968271,893369,171597,10595220,39.67,6.03
Tender_3249,8159075,2753251,1167963,763054,434957,13278300,30.0,7.0
Tender_3250,5553624,1080807,1446045,222166,478361,8781003,32.67,6.73
Tender_3251,7657079,843967,899070,151520,202617,9754253,57.33,4.27
Tender_3252,1387886,4362032,2305880,636068,392254,9084120,26.33,7.37
Tender_3253,4787211,3705783,2277172,944416,418996,12133578,37.0,6.3
Tender_3254,8980934,123077,1070364,228883,114698,10517956,40.33,5.97
Tender_3255,1253057,3012270,603153,846274,78657,5793411,42.0,5.8
Tender_3256,3151574,2355468,686221,463739,294961,6951963,21.33,7.87
Tender_3257,6456326,1168888,439208,773066,455347,9292835,43.0,5.7
Tender_3258,6066988,1773699,2656508,410820,197776,11105791,43.0,5.7
Tender_3259,2405001,730962,2036858,309001,210033,5691855,45.0,5.5
Tender_3260,1839233,947886,1345867,808248,167714,5108948,44.0,5.6
Tender_3261,7002250,1481893,50704,918212,78211,9531270,28.0,7.2
Tender_3262,5989759,3263531,695944,401950,151994,10503178,39.0,6.1
Tender_3263,3601468,1276184,2185053,944879,476426,8484010,41.67,5.83
Tender_3264,8514541,3064917,661842,851051,385172,13477523,34.0,6.6
Tender_3265,9720926,3875186,1073481,288667,140418,15098678,41.33,5.87
Tender_3266,4396624,2370086,371847,618926,60920,7818403,54.67,4.53
Tender_3267,4823682,4402438,1740208,219099,338801,11524228,30.0,7.0
Tender_3268,7774376,2455527,1173881,170964,109504,11684252,53.33,4.67
Tender_3269,4419558,3416942,1090321,592562,431149,9950532,31.33,6.87
Tender_3270,363125,3469521,167348,163366,186713,4350073,31.0,6.9
Tender_3271,1302425,4245835,975600,79569,66360,6669789,47.67,5.23
Tender_3272,5799510,2662463,1524589,620022,94474,10701058,32.0,6.8
Tender_3273,9449558,3340977,2962713,639698,320439,16713385,34.33,6.57
Tender_3274,7126410,2830024,2452428,478204,196768,13083834,38.67,6.13
Tender_3275,7197408,2969748,297934,845929,107657,11418676,33.67,6.63
Tender_3276,9030675,302216,376949,929117,341310,10980267,50.33,4.97
Tender_3277,4940371,3143577,2358133,350425,260608,11053114,59.33,4.07
Tender_3278,9891219,3886555,350088,192683,420731,14741276,51.67,4.83
Tender_3279,3081141,2728496,2202598,697515,208359,8918109,40.0,6.0
Tender_3280,7659431,628466,358058,989737,147972,9783664,21.33,7.87
Tender_3281,2879491,4871538,115981,335837,125088,8327935,44.0,5.6
Tender_3282,6251506,2337709,717297,748591,154505,10209608,24.67,7.53
Tender_3283,4496983,2047559,571695,895191,243242,8254670,39.33,6.07
Tender_3284,5752769,2235038,2691951,294374,357952,11332084,27.0,7.3
Tender_3285,3039070,1173151,260086,232859,273967,4979133,42.67,5.73
Tender_3286,9087635,2920574,1515712,132933,64136,13720990,53.67,4.63
Tender_3287,3375772,2422108,303051,914428,230551,7245910,37.67,6.23
Tender_3288,2699729,4305057,813941,326909,158049,8303685,35.0,6.5
Tender_3289,4803367,1281185,1393877,537588,413909,8429926,38.0,6.2
Tender_3290,690031,2775163,1090418,355993,490421,5402026,49.0,5.1
Tender_3291,2519761,173971,2377172,656638,401657,6129199,43.0,5.7
Tender_3292,3359531,4593968,344906,289059,413589,9001053,38.33,6.17
Tender_3293,742760,3157383,742507,810991,345391,5799032,29.67,7.03
Tender_3294,8948457,627750,2917161,393141,269924,13156433,33.0,6.7
Tender_3295,9993604,765566,2964709,316617,455239,14495735,41.67,5.83
Tender_3296,1424817,3122923,87451,651543,411585,5698319,28.67,7.13
Tender_3297,2487717,2669670,1336398,371000,479246,7344031,43.67,5.63
Tender_3298,2919532,4890794,1248318,171770,493479,9723893,40.67,5.93
Tender_3299,9939422,2325432,1798114,54495,133886,14251349,32.67,6.73
Tender_3300,4932502,3877741,2674201,691191,207498,12383133,40.0,6.0
Tender_3301,3464218,3235246,2440798,569795,473356,10183413,27.67,7.23
Tender_3302,7582225,170853,1885201,828696,318497,10785472,41.0,5.9
Tender_3303,1964634,2584380,2576843,439374,376927,7942158,27.33,7.27
Tender_3304,5450607,3649120,1536933,591302,307622,11535584,39.0,6.1
Tender_3305,807952,3211643,2707482,542019,219331,7488427,32.33,6.77
Tender_3306,1996093,1908355,1426444,814898,200183,6345973,38.67,6.13
Tender_3307,1000751,2246505,2640816,858096,469373,7215541,28.67,7.13
Tender_3308,2692151,1533950,1082581,561112,320300,6190094,36.0,6.4
Tender_3309,4341337,2960185,2954830,747771,136770,11140893,46.0,5.4
Tender_3310,9789584,2619076,1716751,980989,373510,15479910,34.33,6.57
Tender_3311,5207675,1381128,2970458,896589,201668,10657518,30.33,6.97
Tender_3312,2148550,1364070,2814484,827764,321592,7476460,43.33,5.67
Tender_3313,5377483,4303530,1708925,774045,484068,12648051,43.33,5.67
Tender_3314,2388240,4810983,1459271,505996,280733,9445223,33.0,6.7
Tender_3315,1141300,294793,1140614,737680,109339,3423726,47.67,5.23
Tender_3316,1235583,2014301,1532305,668929,130188,5581306,38.33,6.17
Tender_3317,9737378,1384133,1403950,601627,267970,13395058,51.0,4.9
Tender_3318,5277563,3633822,750666,554761,456761,10673573,52.0,4.8
Tender_3319,878950,123996,332758,651118,176391,2163213,31.0,6.9
Tender_3320,2239304,1526131,2272490,465201,462065,6965191,43.33,5.67
Tender_3321,7612900,4878288,2917655,897981,197952,16504776,62.67,3.73
Tender_3322,8300864,4125965,88403,71884,132737,12719853,27.67,7.23
Tender_3323,4565814,2527507,2343838,637367,451135,10525661,23.33,7.67
Tender_3324,1837467,4804955,1368691,518594,269229,8798936,41.33,5.87
Tender_3325,9717674,304206,2482194,986999,290247,13781320,27.67,7.23
Tender_3326,3134873,2806859,1473139,111952,127686,7654509,26.0,7.4
Tender_3327,8746326,3925796,1289110,690108,190225,14841565,47.67,5.23
Tender_3328,3599462,3657615,1163140,668154,162099,9250470,34.67,6.53
Tender_3329,2556983,4752000,2239089,700186,300273,10548531,34.0,6.6
Tender_3330,5161739,3871842,1870329,828670,98373,11830953,46.67,5.33
Tender_3331,9700199,1758083,1039810,264309,397348,13159749,42.33,5.77
Tender_3332,6409132,1837183,1299763,434535,202629,10183242,40.0,6.0
Tender_3333,1825193,2990832,2324111,331450,66201,7537787,39.0,6.1
Tender_3334,2076000,1467686,2078278,784333,317347,6723644,40.33,5.97
Tender_3335,302169,401036,314433,219366,148073,1385077,25.67,7.43
Tender_3336,7359357,937209,2200023,524471,493413,11514473,39.67,6.03
Tender_3337,7773934,4459459,982107,999091,341381,14555972,41.33,5.87
Tender_3338,717524,4719046,809054,494919,420995,7161538,23.33,7.67
Tender_3339,3171701,3910369,2538747,988825,263398,10873040,35.67,6.43
Tender_3340,5167937,3410191,1444086,182931,259710,10464855,26.33,7.37
Tender_3341,1272227,853949,196296,681226,177296,3180994,25.33,7.47
Tender_3342,1429195,814182,1699556,271333,407297,4621563,31.67,6.83
Tender_3343,7147108,534595,2817654,137412,98521,10735290,37.33,6.27
Tender_3344,9893070,3848192,157681,537014,339291,14775248,27.67,7.23
Tender_3345,3945704,3731441,2282843,977498,495520,11433006,44.67,5.53
Tender_3346,5208443,1780377,2998243,714520,360750,11062333,41.67,5.83
Tender_3347,7871192,425052,498839,541707,134629,9471419,47.67,5.23
Tender_3348,9549903,1471798,250100,87590,355706,11715097,42.0,5.8
Tender_3349,7800108,4446911,2628827,563811,52321,15491978,28.0,7.2
Tender_3350,7972461,3645780,2501045,518709,105286,14743281,38.67,6.13
Tender_3351,7149371,3661998,2151707,186356,219495,13368927,35.33,6.47
Tender_3352,2599737,2983928,1355337,876784,457648,8273434,49.0,5.1
Tender_3353,8120466,2144520,1417211,303585,181213,12166995,39.67,6.03
Tender_3354,4779294,3159334,788216,742540,205255,9674639,47.0,5.3
Tender_3355,6730811,4762034,2968460,86508,480955,15028768,50.0,5.0
Tender_3356,7597841,742809,2052062,751114,468703,11612529,33.0,6.7
Tender_3357,3706007,4714546,1788717,701568,65695,10976533,46.0,5.4
Tender_3358,233161,4957097,417713,805301,86462,6499734,34.0,6.6
Tender_3359,7947856,4710536,2584482,944054,436214,16623142,34.67,6.53
Tender_3360,2664573,3071440,2320658,889855,206794,9153320,49.0,5.1
Tender_3361,2178453,3998376,2299126,500458,56658,9033071,43.33,5.67
Tender_3362,8347727,995885,90898,501291,103875,10039676,32.0,6.8
Tender_3363,9504407,3816919,778370,658896,223631,14982223,41.67,5.83
Tender_3364,3146077,1427389,1151080,358070,123484,6206100,22.67,7.73
Tender_3365,1429624,775169,699991,162611,411431,3478826,27.33,7.27
Tender_3366,2486979,2328211,2074148,495850,431788,7816976,39.67,6.03
Tender_3367,8316155,4466156,1168634,245003,468593,14664541,50.67,4.93
Tender_3368,668658,3457270,946869,88683,221862,5383342,41.33,5.87
Tender_3369,1132171,4771717,1199787,311416,413316,7828407,44.0,5.6
Tender_3370,6984306,4595153,378860,167724,80744,12206787,46.0,5.4
Tender_3371,8806344,1480550,2254926,420705,162087,13124612,34.67,6.53
Tender_3372,4443608,2074778,1162408,946946,72342,8700082,41.0,5.9
Tender_3373,6802174,4768756,579623,658931,489203,13298687,27.67,7.23
Tender_3374,5075259,3097295,1173126,179918,403176,9928774,37.67,6.23
Tender_3375,3181348,2992870,964656,395139,76134,7610147,43.33,5.67
Tender_3376,9141534,1112629,1409907,937598,430695,13032363,46.33,5.37
Tender_3377,8581836,2992393,130523,538619,258866,12502237,28.33,7.17
Tender_3378,4360607,953762,1132736,255119,380126,7082350,32.0,6.8
Tender_3379,5250631,344637,2197346,160515,188850,8141979,48.0,5.2
Tender_3380,6336272,2155819,515415,377270,253929,9638705,40.67,5.93
Tender_3381,7615945,2217074,1273366,906812,484061,12497258,31.33,6.87
Tender_3382,6693408,3490263,2332463,247488,182222,12945844,41.0,5.9
Tender_3383,3400641,3648466,1519051,82315,416009,9066482,47.0,5.3
Tender_3384,6328388,3775957,1024344,422816,102242,11653747,49.67,5.03
Tender_3385,8805394,2080147,2564821,686145,310951,14447458,42.0,5.8
Tender_3386,7900519,509908,2917431,465737,495175,12288770,45.67,5.43
Tender_3387,3436109,4346669,1714754,169941,180165,9847638,30.33,6.97
Tender_3388,1829648,4637047,2187108,454948,465841,9574592,32.33,6.77
Tender_3389,1664454,154675,879868,69822,99839,2868658,41.67,5.83
Tender_3390,1633202,2280519,394155,981536,402142,5691554,38.67,6.13
Tender_3391,3808601,4654698,2352872,430500,154987,11401658,42.67,5.73
Tender_3392,6337217,132939,1583397,77880,229620,8361053,49.33,5.07
Tender_3393,5037393,4535327,2531017,428916,333247,12865900,31.33,6.87
Tender_3394,3225646,871206,760384,765035,66686,5688957,40.67,5.93
Tender_3395,5459739,1547863,1222901,78253,363548,8672304,48.67,5.13
Tender_3396,9622837,4163887,2639450,309008,370503,17105685,44.67,5.53
Tender_3397,6619390,1176484,2719616,398393,200370,11114253,37.33,6.27
Tender_3398,8081688,4233051,1058976,147056,420653,13941424,37.33,6.27
Tender_3399,4798800,2429050,1220756,850581,411946,9711133,29.0,7.1
Tender_3400,5564047,3711895,2002180,591805,230164,12100091,28.0,7.2
Tender_3401,7041207,218182,984064,916267,454170,9613890,50.67,4.93
Tender_3402,5079088,444099,2093151,911922,416567,8944827,37.67,6.23
Tender_3403,5439441,771833,600414,263020,253434,7328142,58.0,4.2
Tender_3404,3964656,1122500,1389870,585261,297306,7359593,33.67,6.63
Tender_3405,2211148,847359,1934302,790773,383373,6166955,33.0,6.7
Tender_3406,3647834,3167231,1912392,470099,136005,9333561,42.33,5.77
Tender_3407,2951245,3750232,874333,93617,430728,8100155,37.0,6.3
Tender_3408,9199734,3585089,124251,353417,249404,13511895,51.67,4.83
Tender_3409,2052841,2075130,1884818,751967,327131,7091887,36.33,6.37
Tender_3410,6466924,1110623,1025757,848940,93500,9545744,33.0,6.7
Tender_3411,6679468,646354,2360660,68740,84775,9839997,52.0,4.8
Tender_3412,1504723,321063,1617169,69801,411993,3924749,22.0,7.8
Tender_3413,3604402,4375652,1573329,636909,101784,10292076,51.33,4.87
Tender_3414,7245482,2344277,2720348,163640,63527,12537274,36.67,6.33
Tender_3415,8589870,4668962,1650018,647169,201785,15757804,49.33,5.07
Tender_3416,3314612,3205951,335694,840873,87857,7784987,40.0,6.0
Tender_3417,3879059,2960709,2868019,633364,182679,10523830,31.33,6.87
Tender_3418,4152189,3927974,2514683,193064,229061,11016971,24.67,7.53
Tender_3419,2637414,1713788,220426,222307,416597,5210532,51.0,4.9
Tender_3420,775073,1981337,2314200,737781,90746,5899137,42.67,5.73
Tender_3421,5095844,4442989,289432,198990,286746,10314001,35.33,6.47
Tender_3422,7423906,950013,1672074,622452,209996,10878441,42.67,5.73
Tender_3423,264176,1344839,1033462,840828,357309,3840614,29.0,7.1
Tender_3424,8880668,2197491,2701162,304589,81132,14165042,53.0,4.7
Tender_3425,5113897,261861,1335786,202199,266192,7179935,40.33,5.97
Tender_3426,6678871,972656,725256,913949,187587,9478319,28.33,7.17
Tender_3427,7616066,2499589,1486963,632134,459197,12693949,41.0,5.9
Tender_3428,5189471,4219681,2349121,714152,396349,12868774,41.67,5.83
Tender_3429,762796,3504804,2037316,712219,277926,7295061,38.0,6.2
Tender_3430,8088469,3339178,2587553,749438,155115,14919753,38.0,6.2
Tender_3431,2436248,4987045,2016602,65895,234856,9740646,35.0,6.5
Tender_3432,5028149,3440995,1890849,61521,435014,10856528,24.33,7.57
Tender_3433,9068814,2418202,731014,474134,488461,13180625,40.67,5.93
Tender_3434,969511,4698512,1629882,380244,433741,8111890,38.0,6.2
Tender_3435,2023953,2317366,803090,417791,94437,5656637,27.67,7.23
Tender_3436,8819394,3717410,1488179,453822,93882,14572687,41.67,5.83
Tender_3437,8214739,830328,2743855,365254,199976,12354152,43.67,5.63
Tender_3438,8307275,2882862,2104869,225291,429978,13950275,51.67,4.83
Tender_3439,1917125,991174,1793333,336904,413163,5451699,41.67,5.83
Tender_3440,8389559,328624,701325,383985,55236,9858729,24.67,7.53
Tender_3441,571897,1056520,604325,856541,100114,3189397,24.0,7.6
Tender_3442,9271674,2613379,2429961,968517,364380,15647911,39.0,6.1
Tender_3443,4462610,2784821,2146066,605358,76875,10075730,40.0,6.0
Tender_3444,9544070,1512928,2153868,122174,322676,13655716,47.0,5.3
Tender_3445,1564098,4915324,731507,675820,486290,8373039,34.33,6.57
Tender_3446,5546617,3816536,1220887,525043,209244,11318327,43.67,5.63
Tender_3447,2879707,958880,2200722,217928,344529,6601766,51.33,4.87
Tender_3448,8424718,3923459,2591997,962055,235799,16138028,40.0,6.0
Tender_3449,7777649,1801773,432303,297334,162333,10471392,37.33,6.27
Tender_3450,1977769,167264,2357548,641485,375797,5519863,54.33,4.57
Tender_3451,1413532,2395052,626761,467900,177532,5080777,18.33,8.17
Tender_3452,6222108,1673961,1309327,156936,83783,9446115,49.0,5.1
Tender_3453,2919991,926043,1405310,847792,163616,6262752,43.67,5.63
Tender_3454,8477905,685560,1570149,202789,388217,11324620,43.67,5.63
Tender_3455,5594567,1693076,1002828,354788,343449,8988708,38.67,6.13
Tender_3456,436090,4330405,1912107,224818,354074,7257494,45.67,5.43
Tender_3457,8014445,3835145,769984,745660,215382,13580616,43.67,5.63
Tender_3458,3630194,2819235,1228752,864981,245553,8788715,51.33,4.87
Tender_3459,7341336,159420,695763,185133,280431,8662083,26.33,7.37
Tender_3460,1589475,4831812,212859,727040,91981,7453167,30.0,7.0
Tender_3461,4207888,1702336,282868,804026,406432,7403550,57.67,4.23
Tender_3462,3343080,710400,2605321,233459,294756,7187016,31.0,6.9
Tender_3463,795742,123132,738533,508689,391985,2558081,46.0,5.4
Tender_3464,5296500,3545453,2920631,156121,363328,12282033,44.67,5.53
Tender_3465,1150713,980021,2560069,469164,414664,5574631,41.67,5.83
Tender_3466,6873032,4142232,2562581,509314,209736,14296895,45.33,5.47
Tender_3467,4392857,1993239,1783816,298714,174176,8642802,45.0,5.5
Tender_3468,2931904,2959140,2702338,305890,265809,9165081,42.67,5.73
Tender_3469,3064992,2995782,2752496,466042,227350,9506662,32.0,6.8
Tender_3470,3454170,4205175,2811564,854194,221297,11546400,51.0,4.9
Tender_3471,6697460,1129739,2596383,480946,165881,11070409,40.0,6.0
Tender_3472,3083973,4112996,1496410,95822,121809,8911010,31.0,6.9
Tender_3473,8696029,4103567,703716,435063,178033,14116408,46.33,5.37
Tender_3474,1802943,3805145,2307249,253999,128312,8297648,37.0,6.3
Tender_3475,9955028,1413144,74739,596665,282693,12322269,39.33,6.07
Tender_3476,7857302,1052384,2145785,854769,170058,12080298,44.33,5.57
Tender_3477,9645507,3696928,206830,928552,152149,14629966,33.33,6.67
Tender_3478,1535002,3305837,2073763,663418,289807,7867827,32.67,6.73
Tender_3479,1951849,2523833,2831775,343970,364418,8015845,46.0,5.4
Tender_3480,1576731,595604,1971648,316893,113325,4574201,54.33,4.57
Tender_3481,3758987,762128,339164,382247,328265,5570791,37.0,6.3
Tender_3482,641971,3361863,2233882,224349,55772,6517837,32.33,6.77
Tender_3483,8166699,1592914,2246692,358922,145418,12510645,32.67,6.73
Tender_3484,4042066,2788018,435907,693887,229680,8189558,31.67,6.83
Tender_3485,7254418,4829295,1478969,735448,483298,14781428,32.67,6.73
Tender_3486,6701830,2970376,2272233,67709,73374,12085522,27.0,7.3
Tender_3487,1710909,1743132,1371937,720418,379942,5926338,30.33,6.97
Tender_3488,6993468,2242494,2328846,388841,118733,12072382,41.0,5.9
Tender_3489,7876655,3115961,2937855,952773,433485,15316729,47.67,5.23
Tender_3490,2040114,2360096,740035,356545,399447,5896237,46.33,5.37
Tender_3491,9903730,3915352,669635,804603,130386,15423706,23.0,7.7
Tender_3492,7575791,4068810,1978724,862258,274330,14759913,44.33,5.57
Tender_3493,7440881,1267918,2514338,944319,257435,12424891,53.67,4.63
Tender_3494,7553902,4580358,2982325,120824,241237,15478646,52.33,4.77
Tender_3495,8995885,360329,914068,280283,124047,10674612,36.33,6.37
Tender_3496,1328107,4310041,1566883,218884,333034,7756949,53.0,4.7
Tender_3497,6588109,1732043,1720170,263711,391044,10695077,54.33,4.57
Tender_3498,3105291,4251933,650362,521528,492996,9022110,41.0,5.9
Tender_3499,6930521,1398952,1455138,145827,459244,10389682,37.0,6.3
Tender_3500,6569764,2790992,1551557,423950,139109,11475372,45.67,5.43
Tender_3501,8415253,4927444,2526372,303721,471399,16644189,37.67,6.23
Tender_3502,1786884,3018038,441525,435723,261033,5943203,36.33,6.37
Tender_3503,4743955,3699112,1816998,944060,199717,11403842,32.33,6.77
Tender_3504,1275640,995492,1440214,536544,336608,4584498,45.0,5.5
Tender_3505,7473946,3386040,1348006,674442,103853,12986287,32.0,6.8
Tender_3506,9355048,4587752,853153,405548,180603,15382104,52.67,4.73
Tender_3507,3114652,4815204,1150354,291353,395331,9766894,23.0,7.7
Tender_3508,7028255,1786075,2620380,686978,112094,12233782,51.67,4.83
Tender_3509,6299897,4262416,1755585,780098,130960,13228956,49.0,5.1
Tender_3510,9940521,2748926,1989579,363116,487240,15529382,28.0,7.2
Tender_3511,8470928,246114,291708,816291,127485,9952526,45.0,5.5
Tender_3512,888634,988187,2619929,403437,184030,5084217,43.0,5.7
Tender_3513,1111516,2665786,2824717,734842,164155,7501016,49.67,5.03
Tender_3514,7668986,4744541,2108321,432815,57801,15012464,52.67,4.73
Tender_3515,3810564,1148145,1011422,683437,444638,7098206,30.67,6.93
Tender_3516,2911123,485898,2175384,889857,380558,6842820,39.33,6.07
Tender_3517,2062122,1518525,2597878,182439,187819,6548783,50.0,5.0
Tender_3518,2516042,4270761,911633,623485,352978,8674899,28.33,7.17
Tender_3519,7783911,331195,2701071,705479,417194,11938850,27.67,7.23
Tender_3520,1427905,2104461,2456041,163751,385597,6537755,31.0,6.9
Tender_3521,2558682,3431481,449378,803887,250304,7493732,42.0,5.8
Tender_3522,1629345,2421605,2853757,387683,315685,7608075,41.67,5.83
Tender_3523,6144461,3500089,434994,779627,214009,11073180,45.33,5.47
Tender_3524,2269140,3056650,680817,705660,276664,6988931,34.33,6.57
Tender_3525,7651739,4095093,2195934,832628,405035,15180429,37.0,6.3
Tender_3526,519439,3438495,436266,902664,205877,5502741,26.67,7.33
Tender_3527,6962932,667229,485482,158437,379912,8653992,33.67,6.63
Tender_3528,2778707,462366,131409,868096,197705,4438283,46.67,5.33
Tender_3529,7895686,3120382,511763,383887,401391,12313109,49.0,5.1
Tender_3530,3873562,1274617,2400101,376022,422322,8346624,33.67,6.63
Tender_3531,2032992,4282901,184595,544864,94564,7139916,27.0,7.3
Tender_3532,7394130,1551974,413067,900967,420324,10680462,42.67,5.73
Tender_3533,8166733,1690011,1030105,302023,148459,11337331,36.0,6.4
Tender_3534,3611604,4285430,2874211,450072,118596,11339913,27.33,7.27
Tender_3535,4439472,2992913,2198054,985807,478077,11094323,29.33,7.07
Tender_3536,9720261,2704701,2740786,433751,141140,15740639,34.0,6.6
Tender_3537,2712397,1747003,2769455,249849,430670,7909374,47.33,5.27
Tender_3538,9497109,2822376,220857,142628,79932,12762902,24.33,7.57
Tender_3539,4543805,2665895,1568536,649939,483424,9911599,15.0,8.5
Tender_3540,2624741,4061191,2743789,298750,303048,10031519,39.0,6.1
Tender_3541,7436469,4144860,646670,255606,87349,12570954,35.33,6.47
Tender_3542,8390835,4759843,115485,471653,70532,13808348,39.0,6.1
Tender_3543,8917308,569737,1793314,447143,334256,12061758,27.67,7.23
Tender_3544,7148286,1098353,862425,405981,452338,9967383,38.67,6.13
Tender_3545,1747851,2777658,1476009,200747,182764,6385029,34.0,6.6
Tender_3546,7707936,1543656,2127733,752387,127506,12259218,33.0,6.7
Tender_3547,8592256,3716000,628711,51405,234717,13223089,30.33,6.97
Tender_3548,4893339,191970,2817990,301120,249192,8453611,58.0,4.2
Tender_3549,356744,4212028,1192211,384276,237429,6382688,46.67,5.33
Tender_3550,5636591,2589477,1088075,943381,343606,10601130,43.67,5.63
Tender_3551,5237115,4574878,1281546,336036,355623,11785198,28.67,7.13
Tender_3552,9291376,3328604,1177714,475722,131053,14404469,37.0,6.3
Tender_3553,6048260,4848583,181876,141964,334999,11555682,38.0,6.2
Tender_3554,2094786,1911038,1111030,198697,197981,5513532,44.0,5.6
Tender_3555,2348303,2926119,2302219,589838,458033,8624512,38.33,6.17
Tender_3556,489823,4413420,2409482,61174,313622,7687521,42.33,5.77
Tender_3557,7040733,4478904,175625,426792,322260,12444314,43.67,5.63
Tender_3558,1976203,1675236,797935,709676,419479,5578529,58.67,4.13
Tender_3559,2324866,4885258,423904,370332,110671,8115031,47.67,5.23
Tender_3560,6534196,4166973,1938143,926721,492693,14058726,20.67,7.93
Tender_3561,8796239,4730270,1917562,295774,235094,15974939,59.0,4.1
Tender_3562,8189339,2328751,789296,653206,367751,12328343,57.67,4.23
Tender_3563,4376620,3854164,300368,790470,82117,9403739,34.67,6.53
Tender_3564,8083736,1040688,1967727,155304,485081,11732536,36.67,6.33
Tender_3565,411926,3486231,1234272,916650,278471,6327550,44.33,5.57
Tender_3566,1984916,3452893,1306533,266047,427091,7437480,43.67,5.63
Tender_3567,4738333,2808071,2073695,967738,82978,10670815,43.33,5.67
Tender_3568,4666250,4890731,597246,961941,353420,11469588,35.67,6.43
Tender_3569,8625549,778055,2801066,191210,118126,12514006,47.67,5.23
Tender_3570,7854294,2476745,637060,214422,356020,11538541,49.33,5.07
Tender_3571,8320838,2627752,2037949,437260,428645,13852444,28.0,7.2
Tender_3572,1898520,2271571,1874672,708722,131287,6884772,40.0,6.0
Tender_3573,6357421,3058185,2798692,400951,445700,13060949,37.33,6.27
Tender_3574,9030892,242731,1133797,494184,140557,11042161,50.0,5.0
Tender_3575,2306134,1999451,1089456,847683,88833,6331557,36.33,6.37
Tender_3576,8465257,1600070,2451961,781616,185679,13484583,30.67,6.93
Tender_3577,9507471,1743693,325522,878948,136388,12592022,51.0,4.9
Tender_3578,1845802,1135872,517312,82657,258271,3839914,36.33,6.37
Tender_3579,2637559,1350743,2031379,101306,211062,6332049,40.67,5.93
Tender_3580,6196905,2306393,806896,156752,321902,9788848,47.67,5.23
Tender_3581,8689021,4378050,747547,111881,194720,14121219,32.0,6.8
Tender_3582,4120740,4850630,2402969,168163,412792,11955294,36.33,6.37
Tender_3583,3805337,1045316,1021797,356588,291840,6520878,51.33,4.87
Tender_3584,9651942,2241950,1920225,765621,410491,14990229,44.0,5.6
Tender_3585,9641868,1435292,1417799,407643,450322,13352924,39.67,6.03
Tender_3586,1486694,4198244,551884,371263,269397,6877482,35.0,6.5
Tender_3587,8445931,2318247,2478526,557722,187039,13987465,22.67,7.73
Tender_3588,9899731,1175759,2291083,635235,84960,14086768,42.33,5.77
Tender_3589,3789090,2853917,2980742,299516,294104,10217369,33.33,6.67
Tender_3590,7242425,4339550,2992701,498786,173449,15246911,27.33,7.27
Tender_3591,8613511,4833652,614908,338070,91894,14492035,38.67,6.13
Tender_3592,7256018,962833,2725026,953572,192192,12089641,37.0,6.3
Tender_3593,4661987,3118814,2802016,283243,101191,10967251,32.67,6.73
Tender_3594,2863789,3287681,2730654,534088,485864,9902076,33.67,6.63
Tender_3595,2172733,2787607,2189733,322904,81369,7554346,24.33,7.57
Tender_3596,5502948,2614890,1939116,583197,315978,10956129,42.33,5.77
Tender_3597,1335499,2874495,83066,850247,377728,5521035,26.67,7.33
Tender_3598,1553725,4647125,1118718,197821,326090,7843479,31.0,6.9
Tender_3599,2441878,1363498,2267423,755495,389575,7217869,49.33,5.07
Tender_3600,6757150,4146507,1425151,472677,304204,13105689,36.67,6.33
Tender_3601,1316565,1920165,2556935,190202,332564,6316431,38.33,6.17
Tender_3602,315245,3948535,1506000,276953,166658,6213391,28.33,7.17
Tender_3603,1311042,1647602,2597118,203296,210763,5969821,24.0,7.6
Tender_3604,2465379,296605,884717,886925,262093,4795719,46.0,5.4
Tender_3605,9049280,2265358,2260093,646724,101379,14322834,48.33,5.17
Tender_3606,2731422,1059684,2416038,739409,340213,7286766,41.67,5.83
Tender_3607,8239801,3758241,2138810,632929,316698,15086479,42.33,5.77
Tender_3608,8373322,4357967,2363276,480019,212878,15787462,29.0,7.1
Tender_3609,5489204,1780361,2049119,783292,233810,10335786,53.0,4.7
Tender_3610,6534298,2338031,684019,151977,145963,9854288,28.67,7.13
Tender_3611,6095533,1507796,1622941,634894,181792,10042956,36.0,6.4
Tender_3612,3406363,2332413,490421,825217,177423,7231837,42.67,5.73
Tender_3613,9709426,1099432,2601781,577782,201536,14189957,49.33,5.07
Tender_3614,9602798,4494213,1865304,694666,408127,17065108,31.0,6.9
Tender_3615,3770823,2786079,2483371,120134,404696,9565103,36.67,6.33
Tender_3616,8435910,251217,2080754,579236,215333,11562450,46.0,5.4
Tender_3617,7378388,2529815,358232,927035,466782,11660252,30.67,6.93
Tender_3618,8037418,4504612,1725348,818079,125470,15210927,37.33,6.27
Tender_3619,4030106,594405,2266976,974603,205892,8071982,40.33,5.97
Tender_3620,2830667,195884,1920036,463279,169677,5579543,47.67,5.23
Tender_3621,7272522,3351023,2997515,257015,485398,14363473,51.33,4.87
Tender_3622,5352615,266636,2131485,418641,260175,8429552,33.0,6.7
Tender_3623,2917549,3409751,1492464,854086,317514,8991364,39.0,6.1
Tender_3624,7509172,4229010,1161342,678885,52577,13630986,58.0,4.2
Tender_3625,7164355,209588,546793,867671,92066,8880473,48.67,5.13
Tender_3626,7752733,4507532,409669,126909,306025,13102868,41.67,5.83
Tender_3627,7626033,4246798,2213177,199446,78863,14364317,35.67,6.43
Tender_3628,3751984,3444813,1285154,896097,339239,9717287,49.67,5.03
Tender_3629,665188,1158910,2142246,326244,158010,4450598,44.67,5.53
Tender_3630,1659239,2348556,1712428,509740,332977,6562940,30.67,6.93
Tender_3631,4597536,359023,750543,56032,292408,6055542,37.0,6.3
Tender_3632,2430723,4364015,2535240,341030,353822,10024830,33.33,6.67
Tender_3633,3591351,1169093,1906552,816162,296300,7779458,31.67,6.83
Tender_3634,5909243,4793908,2801090,251546,444835,14200622,29.67,7.03
Tender_3635,2494959,1903535,1137089,152136,54561,5742280,46.67,5.33
Tender_3636,8350330,1908463,2453433,721578,70066,13503870,51.33,4.87
Tender_3637,4691448,539615,1106427,202431,468072,7007993,39.67,6.03
Tender_3638,4215699,359403,2670807,319504,193045,7758458,43.67,5.63
Tender_3639,4941814,4948535,1929122,894379,410943,13124793,44.33,5.57
Tender_3640,827704,1632621,2610556,83746,54684,5209311,35.33,6.47
Tender_3641,7879161,4032390,439637,186771,334899,12872858,53.0,4.7
Tender_3642,1414729,1933613,1753905,718871,224640,6045758,28.33,7.17
Tender_3643,7013112,2040052,540717,126645,152302,9872828,39.67,6.03
Tender_3644,2578953,4466389,2075851,349323,144462,9614978,44.0,5.6
Tender_3645,8341358,2801578,385387,108326,109944,11746593,37.33,6.27
Tender_3646,6925374,1385036,50520,700454,437878,9499262,45.67,5.43
Tender_3647,7514773,4782491,800404,660625,299629,14057922,45.67,5.43
Tender_3648,4552207,1594956,2985487,151519,236326,9520495,31.67,6.83
Tender_3649,8266933,2758356,1888268,803159,292526,14009242,39.33,6.07
Tender_3650,9067053,4243667,1852509,345872,237453,15746554,35.33,6.47
Tender_3651,5360402,307294,2758735,883530,86532,9396493,36.33,6.37
Tender_3652,8953274,1293090,1080390,666337,200364,12193455,32.67,6.73
Tender_3653,7485548,3457295,112620,789582,480350,12325395,52.67,4.73
Tender_3654,672275,4262861,2525014,876666,409274,8746090,43.0,5.7
Tender_3655,5490953,1423932,260963,210190,261915,7647953,35.0,6.5
Tender_3656,6640692,661208,516950,147049,372559,8338458,28.67,7.13
Tender_3657,4410069,4642513,2689335,326889,243773,12312579,34.33,6.57
Tender_3658,2174805,1508115,1554811,146683,195122,5579536,56.67,4.33
Tender_3659,4049713,3057343,2095194,950935,249745,10402930,36.33,6.37
Tender_3660,1535843,4206038,996597,509193,57146,7304817,21.33,7.87
Tender_3661,591319,732067,92599,158337,310064,1884386,29.0,7.1
Tender_3662,6924942,3119384,1286612,74209,261585,11666732,52.0,4.8
Tender_3663,6941584,3895782,1554031,793048,391861,13576306,22.67,7.73
Tender_3664,6799452,4220420,671047,132960,440913,12264792,24.0,7.6
Tender_3665,944237,2047683,837551,681240,329044,4839755,36.0,6.4
Tender_3666,2774952,1131751,395266,145673,125259,4572901,27.33,7.27
Tender_3667,8521677,4128372,2520555,877630,152886,16201120,35.0,6.5
Tender_3668,2608105,2858031,469434,872476,105139,6913185,40.0,6.0
Tender_3669,5295183,2118748,892866,384153,384268,9075218,43.0,5.7
Tender_3670,5796019,3505723,1124811,348023,202737,10977313,31.67,6.83
Tender_3671,2174047,2002987,2828602,106986,455731,7568353,33.33,6.67
Tender_3672,3594024,3831153,930731,222481,242215,8820604,34.0,6.6
Tender_3673,6151230,4621655,2092466,982628,283776,14131755,37.33,6.27
Tender_3674,7089628,3308944,1365169,209988,278253,12251982,33.0,6.7
Tender_3675,307398,459844,2081215,860143,111894,3820494,41.0,5.9
Tender_3676,1074178,1950609,1266175,335048,108906,4734916,37.0,6.3
Tender_3677,1477791,3393648,1768270,877506,77989,7595204,34.67,6.53
Tender_3678,4570350,1076903,2106006,620468,129444,8503171,35.0,6.5
Tender_3679,8929715,4516284,1623558,815189,147693,16032439,34.67,6.53
Tender_3680,437750,2457686,1642281,113953,236086,4887756,31.0,6.9
Tender_3681,6948678,2111456,1387493,484976,94425,11027028,42.67,5.73
Tender_3682,9503533,3530156,1308888,313565,204626,14860768,39.0,6.1
Tender_3683,1403404,4593872,661755,232080,205598,7096709,24.33,7.57
Tender_3684,1182251,1491191,306910,61340,262032,3303724,54.33,4.57
Tender_3685,7399270,1440914,2582857,375574,196352,11994967,30.33,6.97
Tender_3686,5882797,4421675,2293077,945568,333865,13876982,42.0,5.8
Tender_3687,6314567,1678941,1724941,771563,205704,10695716,39.33,6.07
Tender_3688,221291,1841055,1634507,633533,95559,4425945,42.67,5.73
Tender_3689,3622617,3553783,1692931,628715,168045,9666091,52.0,4.8
Tender_3690,6898551,4993344,1245628,805538,493433,14436494,39.33,6.07
Tender_3691,3847893,719925,1493341,496753,440710,6998622,25.0,7.5
Tender_3692,2668757,2918217,303824,254254,137855,6282907,38.33,6.17
Tender_3693,7413653,3802046,1893150,268541,273027,13650417,43.0,5.7
Tender_3694,3079445,1005587,201863,750297,366467,5403659,34.67,6.53
Tender_3695,4004294,4092619,2125241,229070,287262,10738486,41.67,5.83
Tender_3696,8166303,4695712,874347,71138,387326,14194826,29.0,7.1
Tender_3697,5608550,1841772,525366,760539,82815,8819042,16.0,8.4
Tender_3698,563462,186046,2203666,115215,303623,3372012,26.0,7.4
Tender_3699,5825864,529638,313966,803206,485603,7958277,28.67,7.13
Tender_3700,5131000,1728605,1336065,245585,394998,8836253,34.0,6.6
Tender_3701,3715782,336393,1174574,505679,400183,6132611,36.33,6.37
Tender_3702,2784201,3187498,733163,587853,376424,7669139,31.0,6.9
Tender_3703,3301153,3278666,350362,278399,479798,7688378,35.33,6.47
Tender_3704,7235892,2688708,159126,664890,173134,10921750,46.67,5.33
Tender_3705,368908,2209632,716633,534415,140396,3969984,44.33,5.57
Tender_3706,2856687,783861,2870040,965325,332331,7808244,43.33,5.67
Tender_3707,8282208,2797886,51736,108430,452634,11692894,27.33,7.27
Tender_3708,9596834,4740940,2519182,81243,243242,17181441,29.67,7.03
Tender_3709,4798616,3491144,207250,533230,319290,9349530,34.0,6.6
Tender_3710,6727627,4700182,2694777,249364,262725,14634675,35.33,6.47
Tender_3711,3258930,4962239,428081,331873,193319,9174442,46.67,5.33
Tender_3712,4951912,4169764,1712137,642922,144306,11621041,38.0,6.2
Tender_3713,1133053,2669015,2035025,398965,305456,6541514,33.33,6.67
Tender_3714,6500458,4471410,1256378,251146,85109,12564501,33.0,6.7
Tender_3715,8868353,1347509,1335006,612613,390078,12553559,33.0,6.7
Tender_3716,3633357,4681764,929485,739044,221841,10205491,38.33,6.17
Tender_3717,7782033,3903505,1646621,169484,484026,13985669,31.0,6.9
Tender_3718,5834758,2761804,2982302,59643,494839,12133346,41.33,5.87
Tender_3719,4543117,4597818,425529,172826,284512,10023802,33.0,6.7
Tender_3720,6181425,1851644,2643311,305240,492883,11474503,45.33,5.47
Tender_3721,9013565,1709788,994666,984840,69009,12771868,48.33,5.17
Tender_3722,8308772,915794,1413611,947849,107967,11693993,29.67,7.03
Tender_3723,1112573,4681547,882936,495307,248942,7421305,37.67,6.23
Tender_3724,2619854,2146627,2241048,141172,391974,7540675,26.67,7.33
Tender_3725,3784441,252378,1402244,139365,176552,5754980,32.67,6.73
Tender_3726,505329,1188345,2200033,918256,367129,5179092,26.0,7.4
Tender_3727,8103033,827179,584043,863421,204134,10581810,46.33,5.37
Tender_3728,1293263,2840037,1290637,845226,165263,6434426,36.67,6.33
Tender_3729,922694,4227868,104111,765429,480570,6500672,44.67,5.53
Tender_3730,5707790,2110005,1857081,418207,255897,10348980,33.67,6.63
Tender_3731,6524154,1396344,2232642,987541,262803,11403484,33.0,6.7
Tender_3732,5329618,153397,1480995,91808,216401,7272219,35.67,6.43
Tender_3733,896147,4582729,2377775,953602,103485,8913738,37.0,6.3
Tender_3734,575648,1853622,2405565,833011,91767,5759613,38.33,6.17
Tender_3735,7122509,3543167,2475230,936244,116477,14193627,33.0,6.7
Tender_3736,7752794,936725,2783749,472176,398474,12343918,54.33,4.57
Tender_3737,5325358,3266630,924104,375166,115759,10007017,34.67,6.53
Tender_3738,1977924,1650317,2952973,515667,297263,7394144,42.67,5.73
Tender_3739,6453670,1291511,2231596,913352,210195,11100324,47.33,5.27
Tender_3740,9003873,4322604,425152,422209,285106,14458944,42.33,5.77
Tender_3741,6658435,4035355,2909972,448701,157776,14210239,27.33,7.27
Tender_3742,8507601,2524250,898493,828240,86116,12844700,47.0,5.3
Tender_3743,5538743,4063457,1451591,758051,366523,12178365,42.33,5.77
Tender_3744,2399566,2054468,636458,464826,326733,5882051,31.0,6.9
Tender_3745,5013514,829497,1113295,148905,303110,7408321,26.33,7.37
Tender_3746,579129,638152,1731204,253524,200880,3402889,48.0,5.2
Tender_3747,9206900,230088,821454,690151,62314,11010907,41.33,5.87
Tender_3748,8511967,4337565,2944991,486567,259586,16540676,37.33,6.27
Tender_3749,4783705,1180305,1192371,125617,122542,7404540,40.0,6.0
Tender_3750,1870632,591624,1893290,133212,104212,4592970,23.67,7.63
Tender_3751,5502627,2570397,221182,106244,233102,8633552,40.67,5.93
Tender_3752,6403905,4467635,828271,553607,119750,12373168,44.67,5.53
Tender_3753,484543,1037840,331083,464815,407687,2725968,29.33,7.07
Tender_3754,7814000,3509322,2885997,849348,311052,15369719,21.33,7.87
Tender_3755,5769820,900028,2068631,858486,178157,9775122,28.33,7.17
Tender_3756,8452241,633241,1931599,712697,443496,12173274,42.33,5.77
Tender_3757,7158825,1686154,292926,862717,425926,10426548,33.67,6.63
Tender_3758,4540302,2195935,588870,925602,333778,8584487,57.0,4.3
Tender_3759,5336737,3699027,1439593,958787,95224,11529368,35.0,6.5
Tender_3760,9897242,1547637,898581,906183,333889,13583532,40.0,6.0
Tender_3761,6511795,4772787,2336360,973516,499612,15094070,44.0,5.6
Tender_3762,4354548,4707993,2986109,325698,239798,12614146,38.33,6.17
Tender_3763,9801309,3197748,1053607,526362,226366,14805392,46.33,5.37
Tender_3764,3264692,4113997,2900454,287313,261349,10827805,23.33,7.67
Tender_3765,1808162,621458,1840514,355181,345484,4970799,36.67,6.33
Tender_3766,5303295,965130,2485523,83774,225193,9062915,31.0,6.9
Tender_3767,9510184,3225430,2137715,709212,448087,16030628,30.0,7.0
Tender_3768,2213591,4660490,1942719,301712,212338,9330850,41.67,5.83
Tender_3769,9764752,3519010,2535139,500136,244546,16563583,39.33,6.07
Tender_3770,6814667,4063006,468820,156251,285580,11788324,23.67,7.63
Tender_3771,5410637,1006312,121154,888966,428853,7855922,38.0,6.2
Tender_3772,2988033,4875107,2557694,759598,101763,11282195,53.67,4.63
Tender_3773,4821643,3587058,2579711,600523,453542,12042477,33.33,6.67
Tender_3774,1235907,3022214,807660,323014,311129,5699924,41.67,5.83
Tender_3775,4942634,1438127,2825106,86882,238886,9531635,50.67,4.93
Tender_3776,3480734,3730996,605921,470774,139014,8427439,19.67,8.03
Tender_3777,6920285,2113150,87316,149187,259048,9528986,39.0,6.1
Tender_3778,6337844,177932,2404775,339459,98865,9358875,46.67,5.33
Tender_3779,5079541,1489095,2575005,817400,498556,10459597,44.0,5.6
Tender_3780,5624417,3509647,1704315,866441,192604,11897424,42.33,5.77
Tender_3781,1529416,3630375,2450362,796401,132393,8538947,24.0,7.6
Tender_3782,1451622,4508097,1578428,780169,145488,8463804,49.33,5.07
Tender_3783,7351286,489061,2179579,608909,71106,10699941,27.67,7.23
Tender_3784,1043997,1812135,728597,724836,280556,4590121,32.67,6.73
Tender_3785,1046290,1263249,2688623,832645,364076,6194883,41.67,5.83
Tender_3786,3170760,3817705,1575089,382196,313209,9258959,40.33,5.97
Tender_3787,2515184,1854719,313445,986711,496457,6166516,38.33,6.17
Tender_3788,2746528,4822668,2028739,334789,140576,10073300,35.67,6.43
Tender_3789,7364147,4840992,1231641,505793,307159,14249732,40.0,6.0
Tender_3790,5751764,3508759,2657173,856178,481460,13255334,42.33,5.77
Tender_3791,7279725,3745006,489136,942792,166395,12623054,39.67,6.03
Tender_3792,8470719,3323848,1165079,84083,67408,13111137,29.33,7.07
Tender_3793,2831575,1592376,1600788,912876,291886,7229501,40.33,5.97
Tender_3794,7245438,4929241,1583706,102964,129616,13990965,37.67,6.23
Tender_3795,6498710,272817,2443513,588236,126934,9930210,49.0,5.1
Tender_3796,2455137,4943043,760215,155296,425389,8739080,34.0,6.6
Tender_3797,5272316,671748,1547801,121922,69481,7683268,42.33,5.77
Tender_3798,4047937,1805813,852109,579455,289272,7574586,36.67,6.33
Tender_3799,4864542,3929877,1300743,353236,60109,10508507,34.0,6.6
Tender_3800,1831452,2463751,1797665,470821,237108,6800797,40.0,6.0
Tender_3801,7977294,664149,89756,923195,154884,9809278,56.67,4.33
Tender_3802,9312616,1432930,1449115,382320,182389,12759370,27.0,7.3
Tender_3803,1291350,4672902,2320126,57380,465985,8807743,27.0,7.3
Tender_3804,5267023,1853124,2823654,264272,141202,10349275,26.33,7.37
Tender_3805,8972577,699516,465000,186156,52990,10376239,30.0,7.0
Tender_3806,912682,3807376,446283,880220,461537,6508098,46.67,5.33
Tender_3807,9212579,2992802,2528687,969760,414032,16117860,37.67,6.23
Tender_3808,6730662,3270727,1368164,74657,131006,11575216,36.67,6.33
Tender_3809,6249397,4173094,631265,836893,274772,12165421,42.0,5.8
Tender_3810,9569333,1890145,980635,523438,467662,13431213,45.33,5.47
Tender_3811,6608321,2942854,1778113,561158,169499,12059945,31.0,6.9
Tender_3812,1933818,487610,504254,833989,197964,3957635,28.67,7.13
Tender_3813,5213203,4573358,1047239,237969,381329,11453098,32.67,6.73
Tender_3814,7034509,1567247,2110230,475815,373057,11560858,32.33,6.77
Tender_3815,2750608,1193363,1891199,887822,498773,7221765,39.33,6.07
Tender_3816,2154439,183190,1376342,824640,248545,4787156,34.67,6.53
Tender_3817,1490936,2400983,1063163,145225,478245,5578552,42.33,5.77
Tender_3818,9974678,4243087,1300698,394215,71987,15984665,28.67,7.13
Tender_3819,3930006,1950280,817680,502570,306478,7507014,48.33,5.17
Tender_3820,6599848,285199,1129728,924433,61807,9001015,31.33,6.87
Tender_3821,9231189,898075,1525300,622659,485951,12763174,30.0,7.0
Tender_3822,7990167,1195648,2622891,331068,409368,12549142,39.33,6.07
Tender_3823,6279729,2308244,396725,693478,321862,10000038,42.33,5.77
Tender_3824,8234741,4929443,672402,289844,466557,14592987,52.33,4.77
Tender_3825,4818155,332177,1547589,761642,388942,7848505,29.33,7.07
Tender_3826,1713225,3845018,1097139,305473,222534,7183389,50.0,5.0
Tender_3827,3059157,2445881,1641875,166281,101873,7415067,47.0,5.3
Tender_3828,3113997,4378159,2288963,729744,358573,10869436,46.33,5.37
Tender_3829,8727812,4550553,1493832,347572,206030,15325799,41.33,5.87
Tender_3830,8142616,1581713,2345190,514580,384931,12969030,36.0,6.4
Tender_3831,7391775,2434674,1824887,473990,92121,12217447,40.33,5.97
Tender_3832,8348340,930263,2922840,599625,137583,12938651,34.33,6.57
Tender_3833,398598,4690669,1173084,801511,95552,7159414,43.0,5.7
Tender_3834,4405300,1889350,881422,343750,449525,7969347,40.33,5.97
Tender_3835,4679919,1915381,857331,848339,70165,8371135,32.0,6.8
Tender_3836,5372566,3057355,529856,473325,456754,9889856,54.0,4.6
Tender_3837,8156723,3616706,548944,287760,488120,13098253,48.67,5.13
Tender_3838,1391763,4019934,1172836,871227,471484,7927244,43.33,5.67
Tender_3839,9239770,1333947,1616028,619384,167800,12976929,26.0,7.4
Tender_3840,6693529,360614,2583834,619711,114092,10371780,24.0,7.6
Tender_3841,9674913,4075455,965520,290670,214935,15221493,44.67,5.53
Tender_3842,5175665,629078,2469399,355298,218657,8848097,29.33,7.07
Tender_3843,1267071,254841,2960352,622872,159259,5264395,18.33,8.17
Tender_3844,4016291,1017491,645844,989447,340010,7009083,31.0,6.9
Tender_3845,1069396,2369971,2925502,492004,149455,7006328,18.33,8.17
Tender_3846,4460587,4158203,293868,737439,107870,9757967,39.33,6.07
Tender_3847,816596,1972602,2689357,959511,247858,6685924,33.33,6.67
Tender_3848,9257087,2420915,2127980,269095,111830,14186907,29.33,7.07
Tender_3849,1077153,1272072,2055403,767513,235677,5407818,42.0,5.8
Tender_3850,8714537,4023383,309712,79461,176345,13303438,37.33,6.27
Tender_3851,7042176,1551294,2262301,125365,452648,11433784,47.67,5.23
Tender_3852,2557983,1552437,875925,599754,347836,5933935,24.33,7.57
Tender_3853,8935307,516639,2568925,629116,485815,13135802,37.0,6.3
Tender_3854,4083915,4428537,1577812,360635,71316,10522215,34.0,6.6
Tender_3855,5525335,4884536,2801979,376711,321992,13910553,40.67,5.93
Tender_3856,5695874,3191974,1207806,398920,155920,10650494,46.33,5.37
Tender_3857,8280218,4610439,75145,936057,74709,13976568,26.0,7.4
Tender_3858,1894445,186263,1860643,773594,135183,4850128,41.67,5.83
Tender_3859,4926006,316226,1085991,763915,473904,7566042,27.33,7.27
Tender_3860,3287655,983448,1403279,974027,134355,6782764,40.67,5.93
Tender_3861,8033093,3126309,458749,51943,158690,11828784,39.0,6.1
Tender_3862,729800,727651,1623863,778043,280844,4140201,39.67,6.03
Tender_3863,3855687,3990295,171587,218976,456658,8693203,37.0,6.3
Tender_3864,1606805,2477819,2661153,433599,410520,7589896,52.67,4.73
Tender_3865,1596192,4629970,2180048,878396,301095,9585701,41.67,5.83
Tender_3866,3265492,4333117,1354046,211700,366634,9530989,37.67,6.23
Tender_3867,1271414,3536880,432456,639333,264764,6144847,39.0,6.1
Tender_3868,2726736,1211635,2720155,331163,209836,7199525,33.0,6.7
Tender_3869,5828153,1167412,1106277,282254,189500,8573596,27.67,7.23
Tender_3870,9978343,262412,1581891,167906,462676,12453228,38.33,6.17
Tender_3871,5820182,3516207,2945886,209325,156189,12647789,36.33,6.37
Tender_3872,4044781,4599600,1113233,863966,376500,10998080,30.0,7.0
Tender_3873,5820938,3621336,2389928,941293,406767,13180262,31.33,6.87
Tender_3874,3797538,4131591,844231,642493,380521,9796374,25.0,7.5
Tender_3875,2460351,2152055,269561,439280,465094,5786341,36.0,6.4
Tender_3876,5034948,3540222,877160,335615,98461,9886406,38.0,6.2
Tender_3877,2201188,2404206,2314792,291423,141368,7352977,16.33,8.37
Tender_3878,2960816,2101993,1878589,176590,53127,7171115,35.33,6.47
Tender_3879,7314428,4581386,308923,287896,428857,12921490,34.33,6.57
Tender_3880,7154091,2329816,1825182,905321,357612,12572022,28.33,7.17
Tender_3881,6963755,635132,1411110,943217,427176,10380390,32.33,6.77
Tender_3882,3183439,3223546,2995416,819359,388339,10610099,44.0,5.6
Tender_3883,959982,1469281,1619210,89876,496542,4634891,40.67,5.93
Tender_3884,7342520,2187477,417326,301340,116293,10364956,23.0,7.7
Tender_3885,9622742,3101496,646160,441544,168974,13980916,38.67,6.13
Tender_3886,5678087,4468036,2296880,237685,402462,13083150,39.0,6.1
Tender_3887,6777127,1635478,541523,861408,285775,10101311,25.33,7.47
Tender_3888,7119182,617645,601002,671621,460800,9470250,34.67,6.53
Tender_3889,929046,1233445,340351,958284,108841,3569967,41.33,5.87
Tender_3890,259222,4895777,2263617,375701,304797,8099114,34.0,6.6
Tender_3891,2754432,450759,1190479,522367,487000,5405037,41.0,5.9
Tender_3892,8840682,688021,291815,230474,74669,10125661,39.33,6.07
Tender_3893,9394641,3406430,2090801,718968,164764,15775604,40.67,5.93
Tender_3894,5757074,3459707,1678716,921826,241104,12058427,43.0,5.7
Tender_3895,5296035,3190138,1750436,258502,197897,10693008,41.33,5.87
Tender_3896,1351330,985114,2125277,653495,319936,5435152,42.33,5.77
Tender_3897,1372163,3143533,1097069,69580,53517,5735862,41.33,5.87
Tender_3898,1494222,686776,2998947,60243,302991,5543179,54.67,4.53
Tender_3899,2196767,3984622,2439583,840209,87333,9548514,37.33,6.27
Tender_3900,2408270,2303937,182489,956555,354370,6205621,30.67,6.93
Tender_3901,683385,4227337,1275340,443418,377478,7006958,45.67,5.43
Tender_3902,1707713,3799609,2448601,517422,360927,8834272,43.67,5.63
Tender_3903,6218962,1437567,107339,243645,172913,8180426,29.0,7.1
Tender_3904,765916,2136969,1927763,587581,113790,5532019,52.33,4.77
Tender_3905,2795528,2461145,2345473,755089,375321,8732556,44.33,5.57
Tender_3906,6505370,1854469,791753,215819,258258,9625669,38.33,6.17
Tender_3907,1708997,3710640,1330501,390201,468028,7608367,45.33,5.47
Tender_3908,5825078,3396686,970274,227366,184624,10604028,23.67,7.63
Tender_3909,6398454,3612139,863835,931320,81109,11886857,20.33,7.97
Tender_3910,4466267,2469501,1734434,351640,301149,9322991,27.33,7.27
Tender_3911,2738073,3775879,574172,869667,250877,8208668,49.33,5.07
Tender_3912,7979698,4510367,1738084,932840,65180,15226169,50.0,5.0
Tender_3913,7683160,2541711,57736,983252,89353,11355212,49.33,5.07
Tender_3914,1728869,3717303,1833645,319322,217357,7816496,24.67,7.53
Tender_3915,4779527,2915432,886033,241094,405688,9227774,26.0,7.4
Tender_3916,1284124,165235,311527,968275,70964,2800125,31.33,6.87
Tender_3917,1068975,1923145,782684,994573,61903,4831280,26.67,7.33
Tender_3918,5427695,2116125,1565661,266268,210492,9586241,34.33,6.57
Tender_3919,6203646,3104472,2365822,301190,447405,12422535,32.0,6.8
Tender_3920,2488328,260397,1048544,748812,431843,4977924,43.0,5.7
Tender_3921,8948379,2333690,1677378,852660,393203,14205310,40.33,5.97
Tender_3922,9194679,3311671,1653633,145374,164915,14470272,19.67,8.03
Tender_3923,8114130,4338159,2355550,731581,324714,15864134,46.0,5.4
Tender_3924,7016276,494003,676984,140613,240412,8568288,30.33,6.97
Tender_3925,5069312,957747,2871316,267775,421902,9588052,45.33,5.47
Tender_3926,7444209,2790635,1243180,246378,145061,11869463,39.0,6.1
Tender_3927,8705747,1227031,286723,524807,322306,11066614,37.67,6.23
Tender_3928,8771397,3859597,1668777,989079,269967,15558817,36.33,6.37
Tender_3929,558879,3505008,929945,556678,357112,5907622,35.33,6.47
Tender_3930,624732,3030316,2222162,270254,95783,6243247,47.0,5.3
Tender_3931,4431801,416197,2694338,340649,189168,8072153,44.67,5.53
Tender_3932,5574007,3396486,1020971,196138,108323,10295925,44.0,5.6
Tender_3933,2821025,381756,1248408,176524,159113,4786826,43.0,5.7
Tender_3934,6586441,2167013,1871383,510640,120740,11256217,27.0,7.3
Tender_3935,664375,409896,1828038,505741,411090,3819140,47.33,5.27
Tender_3936,5827478,3912980,327924,809556,406513,11284451,44.67,5.53
Tender_3937,2033398,3134479,501181,656275,303927,6629260,49.67,5.03
Tender_3938,8620720,4303877,2102224,527430,63275,15617526,37.67,6.23
Tender_3939,6391102,2977624,1252226,959640,209414,11790006,40.67,5.93
Tender_3940,5119747,3526662,2664461,642194,178591,12131655,54.67,4.53
Tender_3941,6650666,1794989,1564688,970112,448936,11429391,50.33,4.97
Tender_3942,4839529,3576140,1003511,550258,454273,10423711,25.67,7.43
Tender_3943,1773851,2053922,2253312,103625,363789,6548499,24.67,7.53
Tender_3944,3588030,1209503,1902980,958802,104380,7763695,41.33,5.87
Tender_3945,8358072,1553168,1743928,845688,279784,12780640,45.33,5.47
Tender_3946,2637199,1129752,1983518,953974,356395,7060838,46.67,5.33
Tender_3947,9583579,2278348,2437939,682179,340462,15322507,31.0,6.9
Tender_3948,2001119,2921412,2243660,696626,148331,8011148,52.33,4.77
Tender_3949,1969900,4168552,2542871,752568,70355,9504246,28.0,7.2
Tender_3950,2341139,3259432,1941450,632722,148709,8323452,45.67,5.43
Tender_3951,3009795,2076774,2694711,725545,118020,8624845,39.0,6.1
Tender_3952,3704618,2240120,1771354,329904,158545,8204541,41.67,5.83
Tender_3953,1503387,1933345,1320247,432455,446157,5635591,44.0,5.6
Tender_3954,5282533,2178454,1238487,223644,477330,9400448,47.67,5.23
Tender_3955,4597853,4979684,918355,918209,104221,11518322,34.0,6.6
Tender_3956,9571522,4275462,1017776,196510,114224,15175494,32.67,6.73
Tender_3957,9146136,682000,420091,81272,75174,10404673,30.67,6.93
Tender_3958,7011910,1558527,2998714,394073,377507,12340731,30.33,6.97
Tender_3959,4041542,2152712,746631,650989,157742,7749616,44.0,5.6
Tender_3960,7167967,3572333,1364561,795729,317098,13217688,27.0,7.3
Tender_3961,7300994,1948879,1206781,553713,488943,11499310,29.67,7.03
Tender_3962,8659027,412216,2100217,855269,297118,12323847,27.33,7.27
Tender_3963,756337,3759595,2879326,678370,329676,8403304,47.0,5.3
Tender_3964,3139783,1086990,1622859,603386,341880,6794898,27.33,7.27
Tender_3965,5528867,1975880,1646264,767947,96784,10015742,33.67,6.63
Tender_3966,6366957,3831842,124735,607711,460969,11392214,26.33,7.37
Tender_3967,4695093,4017596,2364131,340859,144835,11562514,41.0,5.9
Tender_3968,9337397,617383,147245,752627,419890,11274542,32.33,6.77
Tender_3969,5961825,3425929,136954,822905,349968,10697581,36.33,6.37
Tender_3970,9655926,1100646,1951631,933824,240268,13882295,58.33,4.17
Tender_3971,7703275,4336157,2639920,435011,254227,15368590,39.0,6.1
Tender_3972,5723816,4094611,991455,377872,214909,11402663,35.33,6.47
Tender_3973,3290582,4586443,2903608,368607,410645,11559885,39.33,6.07
Tender_3974,7111431,499076,2021221,219755,254788,10106271,31.33,6.87
Tender_3975,6016233,775047,1710637,786405,156370,9444692,52.0,4.8
Tender_3976,8404469,4704680,759210,549142,241430,14658931,25.67,7.43
Tender_3977,838022,4006563,808821,808650,355304,6817360,33.67,6.63
Tender_3978,1152452,654596,1240123,280131,305658,3632960,55.67,4.43
Tender_3979,6010803,3551653,565288,54007,129597,10311348,44.67,5.53
Tender_3980,7087282,3326217,1338829,413903,353998,12520229,37.0,6.3
Tender_3981,2540631,4882501,2672647,592473,161500,10849752,43.0,5.7
Tender_3982,8987671,1782813,353773,165631,408792,11698680,31.33,6.87
Tender_3983,5060124,2339574,2642054,481038,87279,10610069,55.67,4.43
Tender_3984,4960582,836412,2310740,985792,483410,9576936,34.33,6.57
Tender_3985,3435547,559534,491064,294146,146033,4926324,33.0,6.7
Tender_3986,2649824,2866674,278428,804992,394751,6994669,32.67,6.73
Tender_3987,745750,2957575,668209,710066,149697,5231297,49.0,5.1
Tender_3988,9279728,3303232,1368811,921335,271646,15144752,46.67,5.33
Tender_3989,1677740,4188939,121305,893283,315885,7197152,32.33,6.77
Tender_3990,1763170,1481136,2119230,59365,359949,5782850,39.33,6.07
Tender_3991,7348629,2314242,2295985,580548,499332,13038736,49.33,5.07
Tender_3992,927950,1174245,1394490,129143,145865,3771693,39.67,6.03
Tender_3993,7095412,3878970,838892,718485,376380,12908139,32.67,6.73
Tender_3994,3186443,2396618,1892472,595835,303228,8374596,38.0,6.2
Tender_3995,4329796,1204918,951110,895800,390461,7772085,57.33,4.27
Tender_3996,9685653,391803,2705553,289562,225475,13298046,45.67,5.43
Tender_3997,5678233,3814791,1049461,236688,275831,11055004,45.33,5.47
Tender_3998,7475165,4400757,1417297,989768,356218,14639205,23.33,7.67
Tender_3999,1734324,2579771,70100,598832,482100,5465127,41.33,5.87
Tender_4000,3467466,1595764,815032,173433,443225,6494920,46.0,5.4
Tender_4001,6610836,3977917,103245,423652,321031,11436681,43.33,5.67
Tender_4002,1761295,1094093,1860800,650115,336363,5702666,45.0,5.5
Tender_4003,5640100,3944680,2048947,391181,258929,12283837,42.33,5.77
Tender_4004,1915822,631830,2903559,530736,199089,6181036,28.33,7.17
Tender_4005,341530,1711750,692702,236436,305379,3287797,34.67,6.53
Tender_4006,321083,3783803,893776,502613,442934,5944209,55.0,4.5
Tender_4007,3615800,2975485,2860659,518729,87931,10058604,33.0,6.7
Tender_4008,8516090,3453742,2347769,889318,383703,15590622,32.67,6.73
Tender_4009,4526876,2662111,602433,499619,197883,8488922,39.67,6.03
Tender_4010,9792898,4773535,1952412,747992,388888,17655725,35.33,6.47
Tender_4011,2688425,3611206,2268356,972062,362976,9903025,42.67,5.73
Tender_4012,2281700,3801799,490666,591721,183517,7349403,32.0,6.8
Tender_4013,2719066,1043106,1118439,553392,367287,5801290,19.33,8.07
Tender_4014,350777,2311659,1794694,865588,279389,5602107,36.67,6.33
Tender_4015,7236470,1959118,2554269,905764,196886,12852507,29.33,7.07
Tender_4016,8799688,3563378,1676119,646120,446121,15131426,40.0,6.0
Tender_4017,6681431,2419193,2099338,625949,254800,12080711,16.33,8.37
Tender_4018,810470,4565450,1632502,898602,348415,8255439,43.33,5.67
Tender_4019,1024909,4918034,2018736,537257,440055,8938991,44.0,5.6
Tender_4020,8523692,2039098,385240,471995,136319,11556344,24.0,7.6
Tender_4021,8031085,3247368,1302271,87218,180651,12848593,47.0,5.3
Tender_4022,5701405,799795,2431290,407689,482670,9822849,41.33,5.87
Tender_4023,7703560,3967233,2257966,683674,290087,14902520,39.67,6.03
Tender_4024,1764316,2740690,1077828,145256,455243,6183333,52.0,4.8
Tender_4025,6270279,193591,2363367,802371,490731,10120339,38.0,6.2
Tender_4026,6275216,4298788,1717060,191774,258249,12741087,51.33,4.87
Tender_4027,5745956,4403009,1338867,726248,454254,12668334,47.0,5.3
Tender_4028,6671553,4105352,2361637,523558,62734,13724834,35.0,6.5
Tender_4029,2519489,209444,2341961,643841,97922,5812657,43.67,5.63
Tender_4030,3361101,599672,2032700,900762,310835,7205070,43.67,5.63
Tender_4031,9850526,1404825,2234079,568410,371971,14429811,31.0,6.9
Tender_4032,4964070,3192705,2940303,954377,496471,12547926,35.33,6.47
Tender_4033,8533734,1003745,2750645,194413,210324,12692861,28.33,7.17
Tender_4034,7180079,4528253,2176562,574831,177753,14637478,51.0,4.9
Tender_4035,5378830,4762671,2903605,626532,187921,13859559,42.0,5.8
Tender_4036,7054187,1535285,2752590,201406,477800,12021268,35.0,6.5
Tender_4037,1256142,4780220,2070379,316199,168039,8590979,36.0,6.4
Tender_4038,4931292,1030752,872175,883645,454740,8172604,29.0,7.1
Tender_4039,5856876,3409451,2174038,922950,160486,12523801,47.67,5.23
Tender_4040,7859945,479836,321150,936287,309225,9906443,31.33,6.87
Tender_4041,8760225,1502555,704239,985787,331654,12284460,32.67,6.73
Tender_4042,6475832,2833133,2427628,499624,425311,12661528,32.0,6.8
Tender_4043,315332,2195925,1168423,259061,57880,3996621,37.0,6.3
Tender_4044,9923325,2078006,1625322,413801,190388,14230842,46.67,5.33
Tender_4045,5841778,2298568,1592426,632767,330501,10696040,39.0,6.1
Tender_4046,2214932,2544498,2106279,747194,355306,7968209,39.67,6.03
Tender_4047,9440507,679574,1797891,411962,50820,12380754,50.0,5.0
Tender_4048,685612,1059879,2820827,786694,284522,5637534,54.67,4.53
Tender_4049,5449025,109627,193876,862276,409627,7024431,36.0,6.4
Tender_4050,1225370,1540476,2756314,685770,466158,6674088,32.0,6.8
Tender_4051,6210658,1564606,618989,279163,125285,8798701,34.0,6.6
Tender_4052,6509908,379736,1196000,201817,362033,8649494,38.0,6.2
Tender_4053,496822,716638,2527697,125134,452620,4318911,37.67,6.23
Tender_4054,3810477,1977513,448726,111715,478038,6826469,37.33,6.27
Tender_4055,2350166,4820987,583701,702135,428629,8885618,21.67,7.83
Tender_4056,6738939,1229390,1342845,633383,159574,10104131,43.33,5.67
Tender_4057,7008375,699102,1763403,397307,106493,9974680,32.0,6.8
Tender_4058,2448357,3549631,2423609,417891,432787,9272275,39.67,6.03
Tender_4059,5905773,308422,142095,456158,127157,6939605,59.67,4.03
Tender_4060,1830536,4911056,736133,388195,130165,7996085,43.67,5.63
Tender_4061,1118482,1271256,1587038,906403,312946,5196125,38.0,6.2
Tender_4062,4106331,1347972,2569972,553972,450955,9029202,41.67,5.83
Tender_4063,1827393,4525417,2824475,457301,251177,9885763,38.67,6.13
Tender_4064,6310405,1685198,1649480,622399,342425,10609907,44.0,5.6
Tender_4065,4362004,3946958,2293098,61675,161530,10825265,34.33,6.57
Tender_4066,622898,114663,416720,171173,214959,1540413,20.33,7.97
Tender_4067,8742686,4184983,1870866,571336,97243,15467114,26.67,7.33
Tender_4068,8053953,1560456,1835396,608548,466792,12525145,34.0,6.6
Tender_4069,761536,3611531,1318523,196713,123854,6012157,44.67,5.53
Tender_4070,4206310,2152844,90179,909679,476659,7835671,31.67,6.83
Tender_4071,4006832,2121282,388598,676989,52873,7246574,45.0,5.5
Tender_4072,213039,1345843,2092603,720944,388100,4760529,23.0,7.7
Tender_4073,2921685,4837728,1170156,229762,183164,9342495,37.33,6.27
Tender_4074,4836382,1742385,2347239,492953,437905,9856864,31.67,6.83
Tender_4075,7083460,1960886,2510550,581269,463738,12599903,32.0,6.8
Tender_4076,8321000,536843,291009,620036,405538,10174426,29.67,7.03
Tender_4077,8259924,202131,2540129,801314,133395,11936893,35.67,6.43
Tender_4078,7228183,1382452,2984990,866139,243685,12705449,30.0,7.0
Tender_4079,7245971,1809214,222341,696052,271097,10244675,26.33,7.37
Tender_4080,9489306,1527878,533530,595947,177652,12324313,35.0,6.5
Tender_4081,9510568,4653360,968205,436188,208297,15776618,44.0,5.6
Tender_4082,7678566,2807845,149978,136056,208288,10980733,48.67,5.13
Tender_4083,288906,1467479,2913372,421428,150404,5241589,37.67,6.23
Tender_4084,7328781,1106035,823433,412465,458988,10129702,34.0,6.6
Tender_4085,5127612,1286621,2396229,712150,83658,9606270,55.67,4.43
Tender_4086,1706115,2345092,2080765,155959,146452,6434383,44.33,5.57
Tender_4087,1150107,170181,2943186,665990,112759,5042223,26.0,7.4
Tender_4088,8722152,442397,2184951,461348,418970,12229818,43.67,5.63
Tender_4089,1096813,3364772,998478,398212,489995,6348270,48.67,5.13
Tender_4090,1313837,1257219,874425,897127,271853,4614461,43.0,5.7
Tender_4091,328793,1194464,725028,509915,419195,3177395,26.67,7.33
Tender_4092,8082734,2369670,2760112,745015,356700,14314231,33.33,6.67
Tender_4093,2818293,887138,307399,845655,63833,4922318,32.0,6.8
Tender_4094,9650865,4153523,1837830,635658,357703,16635579,40.67,5.93
Tender_4095,7479415,2644612,2770536,130508,81535,13106606,33.0,6.7
Tender_4096,8512745,4529072,2810984,479308,291735,16623844,48.0,5.2
Tender_4097,3070662,3498348,1890836,727347,356403,9543596,43.67,5.63
Tender_4098,3152231,467054,413539,689239,153041,4875104,35.33,6.47
Tender_4099,4960965,281712,1339736,166852,354631,7103896,26.67,7.33
Tender_4100,9044719,3463820,1839942,852983,399781,15601245,35.67,6.43
Tender_4101,5883161,2355289,2943853,539836,464976,12187115,34.67,6.53
Tender_4102,6093500,4395276,2062804,989646,254606,13795832,33.67,6.63
Tender_4103,2136967,4325618,2677963,208164,345125,9693837,39.67,6.03
Tender_4104,5925513,1422699,308282,959384,389813,9005691,36.67,6.33
Tender_4105,7716391,2202538,855827,849911,65480,11690147,57.33,4.27
Tender_4106,802179,3902038,441589,254109,257167,5657082,20.67,7.93
Tender_4107,3599899,3743447,607000,171744,413257,8535347,31.0,6.9
Tender_4108,4532319,311365,2193454,312145,382242,7731525,31.0,6.9
Tender_4109,3605964,1522691,1772311,784336,335561,8020863,35.0,6.5
Tender_4110,4951349,230938,2553017,76759,397572,8209635,32.33,6.77
Tender_4111,9820135,1567093,405164,327600,130462,12250454,33.33,6.67
Tender_4112,1756359,3988985,2930499,179005,337489,9192337,55.0,4.5
Tender_4113,7566639,3464398,1093044,396442,291037,12811560,38.67,6.13
Tender_4114,1486920,4977284,644723,308407,486666,7904000,42.0,5.8
Tender_4115,1039661,282270,562386,416745,60745,2361807,26.0,7.4
Tender_4116,1086719,2350600,1223616,368920,58798,5088653,50.0,5.0
Tender_4117,4113186,2744987,2126325,975453,413814,10373765,48.0,5.2
Tender_4118,5950184,493085,1484620,594437,302209,8824535,57.67,4.23
Tender_4119,8460220,4780755,745406,154619,256320,14397320,51.0,4.9
Tender_4120,884261,1664066,1500096,246962,140802,4436187,49.33,5.07
Tender_4121,5812874,237623,811286,542608,224239,7628630,45.67,5.43
Tender_4122,9157973,1525298,2960930,95649,352561,14092411,40.67,5.93
Tender_4123,4007527,3729149,2198377,239845,370483,10545381,35.67,6.43
Tender_4124,3878781,1210795,1318810,499376,453720,7361482,22.67,7.73
Tender_4125,5368373,3935214,999423,874995,263651,11441656,36.0,6.4
Tender_4126,4912047,4722654,2303625,855776,144003,12938105,30.33,6.97
Tender_4127,4299045,1485130,1840844,589060,106699,8320778,35.33,6.47
Tender_4128,8383361,4219378,868802,954599,196701,14622841,56.67,4.33
Tender_4129,4971007,1452404,827463,659865,364677,8275416,47.0,5.3
Tender_4130,8432295,2880005,648499,827437,144611,12932847,30.0,7.0
Tender_4131,6489374,1893977,750811,737999,252212,10124373,41.67,5.83
Tender_4132,1187970,4937661,347683,237468,91825,6802607,37.33,6.27
Tender_4133,7407855,4510972,2071257,109376,413303,14512763,31.67,6.83
Tender_4134,3691770,1687561,291980,921420,198695,6791426,41.67,5.83
Tender_4135,6948450,4208317,2858461,67920,135987,14219135,24.0,7.6
Tender_4136,9570188,2529172,1514889,957458,237180,14808887,35.67,6.43
Tender_4137,5856557,2753441,252166,406319,83753,9352236,50.0,5.0
Tender_4138,3700093,1992887,1904362,626568,366241,8590151,31.0,6.9
Tender_4139,9659949,3823283,1447868,224609,201457,15357166,45.33,5.47
Tender_4140,3288269,2335969,1982541,102826,390926,8100531,56.67,4.33
Tender_4141,8710921,539124,2368527,691728,318191,12628491,38.0,6.2
Tender_4142,6893776,730062,83010,303832,265988,8276668,22.33,7.77
Tender_4143,3639553,1663808,1169578,957571,410919,7841429,34.0,6.6
Tender_4144,6505300,3326269,2075405,411552,308665,12627191,40.67,5.93
Tender_4145,9970055,4650209,2415100,522453,227361,17785178,33.0,6.7
Tender_4146,4099961,2336802,2748204,355993,250540,9791500,26.33,7.37
Tender_4147,4424203,402745,2531387,971815,428477,8758627,42.67,5.73
Tender_4148,1542018,4598902,1187174,348961,405775,8082830,21.33,7.87
Tender_4149,1270749,2987153,320367,995041,332991,5906301,38.33,6.17
Tender_4150,6304909,3593155,715867,118494,161928,10894353,36.67,6.33
Tender_4151,2497174,2553670,1633321,603878,258270,7546313,37.67,6.23
Tender_4152,6173733,1763272,1170202,160562,157589,9425358,34.33,6.57
Tender_4153,7222195,1296150,585877,349086,156455,9609763,43.67,5.63
Tender_4154,4713392,179103,2385750,483403,180843,7942491,22.0,7.8
Tender_4155,1900494,3550627,2240548,969356,94626,8755651,48.67,5.13
Tender_4156,6899108,2883094,1890589,670551,362281,12705623,48.67,5.13
Tender_4157,6134927,2000741,2428498,744946,416420,11725532,33.0,6.7
Tender_4158,1025987,1087089,1946032,862763,408901,5330772,35.0,6.5
Tender_4159,7439017,1322216,266478,409486,180588,9617785,30.33,6.97
Tender_4160,5180427,2311776,1590790,763186,155546,10001725,36.67,6.33
Tender_4161,3748166,4449211,1039425,718319,175771,10130892,26.33,7.37
Tender_4162,4015724,2103489,651310,97657,466660,7334840,47.0,5.3
Tender_4163,632499,4560942,1814396,983174,333661,8324672,25.0,7.5
Tender_4164,5992550,1583745,2205537,549188,141558,10472578,38.67,6.13
Tender_4165,5148539,3868499,1663928,825514,461457,11967937,34.33,6.57
Tender_4166,1223123,515177,1788692,117833,399787,4044612,36.0,6.4
Tender_4167,6978933,3374787,1998642,795449,206875,13354686,41.67,5.83
Tender_4168,9762533,2753644,2554578,364913,249240,15684908,38.0,6.2
Tender_4169,7342635,2652560,304568,123952,251935,10675650,25.0,7.5
Tender_4170,6403493,2928064,510946,876381,64803,10783687,28.33,7.17
Tender_4171,1876201,3885269,1788129,441286,369018,8359903,46.33,5.37
Tender_4172,4829491,2095438,2215101,842846,428036,10410912,43.0,5.7
Tender_4173,8777677,2310714,2972414,576636,150834,14788275,52.67,4.73
Tender_4174,2562674,4785358,1669977,107124,304881,9430014,29.0,7.1
Tender_4175,6662311,2858643,2947843,912770,177613,13559180,21.33,7.87
Tender_4176,9562083,2385568,494277,801539,459444,13702911,39.67,6.03
Tender_4177,3160268,1090610,2330500,317943,120436,7019757,44.0,5.6
Tender_4178,7851924,1922582,467797,488174,495011,11225488,40.67,5.93
Tender_4179,2569750,1238158,1170961,418604,339651,5737124,30.33,6.97
Tender_4180,5887847,2057296,2013103,527373,135416,10621035,39.33,6.07
Tender_4181,7018054,3757637,1642051,187555,81207,12686504,35.33,6.47
Tender_4182,4335115,3297304,627830,131214,396241,8787704,29.33,7.07
Tender_4183,4355985,704080,618252,152331,109946,5940594,34.67,6.53
Tender_4184,819287,3596713,754716,628926,216617,6016259,23.33,7.67
Tender_4185,1247729,1637917,413232,518636,233714,4051228,38.33,6.17
Tender_4186,9952303,3185441,1141091,893759,411887,15584481,22.33,7.77
Tender_4187,2681234,1628294,1952607,205476,75680,6543291,25.67,7.43
Tender_4188,2802603,1973482,2873179,578094,279087,8506445,45.0,5.5
Tender_4189,4872341,369436,380688,790530,311521,6724516,38.67,6.13
Tender_4190,1417830,4731177,482075,837015,235459,7703556,40.67,5.93
Tender_4191,1732680,667137,2464041,610376,390801,5865035,29.67,7.03
Tender_4192,8154928,3968572,1551406,322495,137602,14135003,33.67,6.63
Tender_4193,8147302,1923697,591948,264705,60123,10987775,43.33,5.67
Tender_4194,2183442,1713712,1765618,913915,492276,7068963,46.67,5.33
Tender_4195,6368096,2296396,1714564,397732,112655,10889443,42.67,5.73
Tender_4196,6104954,2609398,1509573,702421,426593,11352939,23.67,7.63
Tender_4197,3421433,2894682,836707,539885,463137,8155844,43.67,5.63
Tender_4198,7397990,1314813,892999,699393,326421,10631616,24.0,7.6
Tender_4199,8432251,226188,158677,856269,268536,9941921,52.33,4.77
Tender_4200,4262329,2212197,1695795,974166,70393,9214880,38.0,6.2
Tender_4201,2089915,3083252,1895293,926016,175153,8169629,37.67,6.23
Tender_4202,8312071,1339722,1947671,747599,393854,12740917,33.33,6.67
Tender_4203,5082301,2450805,968267,958906,125368,9585647,55.67,4.43
Tender_4204,2829907,1321305,2647946,99494,109611,7008263,39.67,6.03
Tender_4205,1307186,597911,1404568,253227,209819,3772711,38.67,6.13
Tender_4206,1948078,3070636,1242659,443086,211333,6915792,51.0,4.9
Tender_4207,5940668,1495479,1127140,450605,436209,9450101,57.67,4.23
Tender_4208,2417986,3569248,2046599,411474,260449,8705756,46.0,5.4
Tender_4209,1914586,4225275,1443089,164766,217202,7964918,31.0,6.9
Tender_4210,9935178,1792399,1539021,123466,184444,13574508,48.33,5.17
Tender_4211,2867419,4448256,1825038,490061,198082,9828856,33.0,6.7
Tender_4212,7470859,4382606,2216097,939548,367887,15376997,34.0,6.6
Tender_4213,4183543,203446,2866598,677164,364932,8295683,45.0,5.5
Tender_4214,7243544,3887869,623697,681378,328157,12764645,32.33,6.77
Tender_4215,319945,3276372,1425522,575429,421782,6019050,51.67,4.83
Tender_4216,9893592,1053590,1138759,492863,256275,12835079,47.33,5.27
Tender_4217,8509586,2185772,709925,53925,361167,11820375,44.33,5.57
Tender_4218,861646,1110505,2014711,567013,67558,4621433,47.33,5.27
Tender_4219,8086395,4699284,2863298,899103,411563,16959643,22.67,7.73
Tender_4220,3390775,4087160,2081638,568549,255176,10383298,44.0,5.6
Tender_4221,6422040,3319255,572443,726552,228960,11269250,38.0,6.2
Tender_4222,6306160,2016777,2409105,596465,137041,11465548,41.0,5.9
Tender_4223,1880457,2937093,1451273,913229,137923,7319975,35.67,6.43
Tender_4224,4102511,2535785,2780405,789018,297864,10505583,33.0,6.7
Tender_4225,1772180,451224,1363947,363752,134476,4085579,55.33,4.47
Tender_4226,594615,302991,376542,837624,79865,2191637,39.0,6.1
Tender_4227,4236220,1536020,1857129,80019,209155,7918543,33.67,6.63
Tender_4228,9737549,1253919,2285807,287718,179131,13744124,46.0,5.4
Tender_4229,9235368,173613,2864174,164737,325421,12763313,44.0,5.6
Tender_4230,7387315,1430774,2007935,757659,398720,11982403,27.67,7.23
Tender_4231,9279925,3742963,2091485,81772,90060,15286205,40.33,5.97
Tender_4232,8930468,3923619,219809,442163,203581,13719640,32.33,6.77
Tender_4233,7408206,4789748,117045,798750,96594,13210343,42.33,5.77
Tender_4234,3463031,4772325,316877,683619,129238,9365090,30.67,6.93
Tender_4235,5785327,3611150,2383937,758222,84742,12623378,44.0,5.6
Tender_4236,5148211,3118216,1196036,400464,195507,10058434,42.33,5.77
Tender_4237,1884583,960457,2337824,988781,240717,6412362,41.33,5.87
Tender_4238,2560666,1418242,1227177,824095,225198,6255378,32.33,6.77
Tender_4239,3978784,4103705,1550044,305366,270538,10208437,28.0,7.2
Tender_4240,360416,115091,1854791,237269,268540,2836107,45.0,5.5
Tender_4241,8124820,2733200,1281020,429689,202288,12771017,42.33,5.77
Tender_4242,6168044,4202396,2673886,784022,195000,14023348,38.0,6.2
Tender_4243,6555608,340682,2214837,62988,489438,9663553,34.0,6.6
Tender_4244,7737810,1440501,2956460,581673,430071,13146515,46.33,5.37
Tender_4245,5262029,4151070,201245,756334,240339,10611017,40.67,5.93
Tender_4246,5446174,1698796,988384,427554,299367,8860275,33.0,6.7
Tender_4247,4381553,273082,1599381,597259,401490,7252765,56.33,4.37
Tender_4248,8009822,2049965,1743254,78513,290367,12171921,39.67,6.03
Tender_4249,8411755,4457354,1886265,325886,128417,15209677,36.67,6.33
Tender_4250,804836,1638638,1829927,750722,75566,5099689,27.33,7.27
Tender_4251,6833620,591902,535059,196827,51837,8209245,43.33,5.67
Tender_4252,4454273,555594,360108,445819,340943,6156737,30.33,6.97
Tender_4253,2810976,171092,1500275,896048,61331,5439722,45.33,5.47
Tender_4254,2493463,416633,1797068,523424,490671,5721259,50.67,4.93
Tender_4255,6359812,1927876,1243591,197912,245858,9975049,38.0,6.2
Tender_4256,7138718,199416,283436,502463,59334,8183367,35.0,6.5
Tender_4257,3696287,848833,1379069,664763,398393,6987345,57.33,4.27
Tender_4258,8727277,1017546,2306396,485581,320227,12857027,40.67,5.93
Tender_4259,6304934,612290,2114502,456724,73278,9561728,36.67,6.33
Tender_4260,1339580,4790311,938066,637806,186542,7892305,18.0,8.2
Tender_4261,7492796,510803,1353416,192036,236511,9785562,38.0,6.2
Tender_4262,679005,524036,800429,821307,330955,3155732,36.67,6.33
Tender_4263,3527618,4859309,730641,363162,377467,9858197,23.67,7.63
Tender_4264,2036844,1554960,2961822,839628,238188,7631442,33.33,6.67
Tender_4265,2789751,4790003,805956,670801,195155,9251666,34.0,6.6
Tender_4266,1267477,1511723,1557141,904145,130188,5370674,28.33,7.17
Tender_4267,1562277,1042524,843608,338891,313015,4100315,30.67,6.93
Tender_4268,5231603,130790,2295013,899596,225968,8782970,40.33,5.97
Tender_4269,4642610,1755077,1691105,529132,145578,8763502,49.0,5.1
Tender_4270,2420401,4662197,532082,332210,161779,8108669,28.67,7.13
Tender_4271,3418464,4544549,2859688,445080,98635,11366416,39.33,6.07
Tender_4272,9277746,4135415,2273277,705146,220577,16612161,30.0,7.0
Tender_4273,1522591,4392362,569522,242908,332524,7059907,46.33,5.37
Tender_4274,5428726,981495,1917276,392513,359780,9079790,44.67,5.53
Tender_4275,5761156,2903885,1083558,696180,368641,10813420,24.67,7.53
Tender_4276,4828224,1060877,560447,508944,322996,7281488,33.33,6.67
Tender_4277,1151395,2535083,1105280,486597,151621,5429976,42.0,5.8
Tender_4278,4307782,981656,1002563,643936,403111,7339048,33.67,6.63
Tender_4279,2515372,4004747,266396,184413,119604,7090532,48.0,5.2
Tender_4280,8200116,4325700,2650301,312272,125401,15613790,44.0,5.6
Tender_4281,4760549,4969829,196680,482854,207452,10617364,23.0,7.7
Tender_4282,1922044,1446836,778905,731321,135622,5014728,50.0,5.0
Tender_4283,5948080,3668988,260442,391447,338680,10607637,32.33,6.77
Tender_4284,4476100,3178579,1730390,604727,185360,10175156,58.0,4.2
Tender_4285,7467042,2494583,2189926,337653,361235,12850439,42.33,5.77
Tender_4286,4414330,563352,369916,111651,281036,5740285,21.33,7.87
Tender_4287,3271998,758673,2371507,269835,160273,6832286,30.0,7.0
Tender_4288,2804164,3404672,957418,836488,331409,8334151,52.0,4.8
Tender_4289,6306225,1577939,1844575,397859,254635,10381233,43.33,5.67
Tender_4290,6404078,2460287,2580288,199317,269663,11913633,20.67,7.93
Tender_4291,9731952,1270237,551113,478728,258297,12290327,31.67,6.83
Tender_4292,2536732,3078637,593479,197198,83671,6489717,48.67,5.13
Tender_4293,2488834,3175094,1099618,126207,267459,7157212,35.33,6.47
Tender_4294,8578051,3189518,2226241,991608,452715,15438133,33.33,6.67
Tender_4295,1441535,1962852,2666839,228895,66093,6366214,42.33,5.77
Tender_4296,3274931,4379349,2880570,109570,89781,10734201,32.33,6.77
Tender_4297,358354,4145986,1980730,352816,499263,7337149,44.33,5.57
Tender_4298,8090457,514299,467655,62688,66628,9201727,49.67,5.03
Tender_4299,5277368,4885549,2858361,545662,295526,13862466,39.33,6.07
Tender_4300,4810830,4111788,1077323,627072,375182,11002195,39.33,6.07
Tender_4301,1512044,4974991,2117505,371422,212846,9188808,35.0,6.5
Tender_4302,1970689,848737,950880,329622,404870,4504798,52.67,4.73
Tender_4303,5125712,2761896,2404875,302218,430340,11025041,33.67,6.63
Tender_4304,8891499,2638366,2329247,544328,230468,14633908,31.67,6.83
Tender_4305,6657236,1433177,2103079,167247,54879,10415618,50.67,4.93
Tender_4306,2944839,1567788,2949666,99298,372620,7934211,28.67,7.13
Tender_4307,8368466,530088,694509,79565,389287,10061915,22.0,7.8
Tender_4308,8726979,3116183,1099774,936022,335751,14214709,21.33,7.87
Tender_4309,3373372,4705822,2677794,292167,488143,11537298,41.0,5.9
Tender_4310,2400420,1771674,242413,148181,235247,4797935,34.67,6.53
Tender_4311,8657628,1259557,2959979,874200,185770,13937134,28.33,7.17
Tender_4312,4993189,4463484,183191,892166,376826,10908856,40.67,5.93
Tender_4313,5621276,2002442,628210,385773,357457,8995158,34.67,6.53
Tender_4314,3428605,4038540,1301521,289524,96621,9154811,28.33,7.17
Tender_4315,8937136,625430,1064102,692362,238512,11557542,34.0,6.6
Tender_4316,2136359,3244356,699235,144633,297290,6521873,42.33,5.77
Tender_4317,2976850,4546846,1128139,208656,372456,9232947,30.67,6.93
Tender_4318,9799460,4143985,75175,110280,434012,14562912,47.0,5.3
Tender_4319,2294047,2862916,1488614,930591,237708,7813876,40.0,6.0
Tender_4320,7481790,2717543,202820,919968,262571,11584692,35.33,6.47
Tender_4321,7479594,2234746,2939593,996346,468017,14118296,55.67,4.43
Tender_4322,1159749,3499046,1165561,323187,83601,6231144,42.33,5.77
Tender_4323,4721716,1898748,2463765,85138,348337,9517704,57.67,4.23
Tender_4324,400638,1623115,412355,819336,219557,3475001,38.33,6.17
Tender_4325,659455,2327922,466877,624735,296586,4375575,38.67,6.13
Tender_4326,9923708,1362840,1096049,95502,146878,12624977,20.67,7.93
Tender_4327,9550113,2543313,2283123,474325,106292,14957166,40.0,6.0
Tender_4328,3977088,3387189,249166,259605,450178,8323226,18.0,8.2
Tender_4329,7296052,3497130,2324546,872027,414611,14404366,40.0,6.0
Tender_4330,9293285,587222,350932,520610,454479,11206528,34.0,6.6
Tender_4331,7733979,2717777,2742863,461953,468211,14124783,32.0,6.8
Tender_4332,902967,4171348,2380694,281745,302867,8039621,37.0,6.3
Tender_4333,1311756,1621470,382596,124230,493727,3933779,43.33,5.67
Tender_4334,8086470,2250188,1023794,403158,322244,12085854,29.33,7.07
Tender_4335,2630154,4383815,2032748,578493,448033,10073243,27.67,7.23
Tender_4336,1477725,2339098,2448378,485848,367880,7118929,33.33,6.67
Tender_4337,6367058,1390092,2007245,875920,189804,10830119,29.0,7.1
Tender_4338,1656454,1641329,2909824,676075,52800,6936482,30.67,6.93
Tender_4339,9144746,298729,2743508,990039,456019,13633041,40.33,5.97
Tender_4340,4633163,292544,677717,73505,131626,5808555,30.67,6.93
Tender_4341,8020228,222041,1227662,370717,420067,10260715,40.33,5.97
Tender_4342,4948417,993550,2680235,972484,246906,9841592,34.67,6.53
Tender_4343,4545113,2548696,338049,429837,412911,8274606,25.0,7.5
Tender_4344,899599,1977498,1932004,136086,259625,5204812,55.67,4.43
Tender_4345,1241670,921540,1117908,300606,397559,3979283,41.0,5.9
Tender_4346,1213691,433517,816185,218174,457919,3139486,50.0,5.0
Tender_4347,5530770,666977,593541,704325,306656,7802269,50.33,4.97
Tender_4348,4453945,3739726,2835639,272177,408870,11710357,39.0,6.1
Tender_4349,4392109,608212,1786624,174628,261995,7223568,49.67,5.03
Tender_4350,1712204,3802881,1379725,970143,214051,8079004,30.33,6.97
Tender_4351,2914180,317030,1110275,141199,195844,4678528,56.33,4.37
Tender_4352,2331460,3713454,2397186,306441,168343,8916884,29.0,7.1
Tender_4353,2940667,3951698,2293226,907646,324706,10417943,48.0,5.2
Tender_4354,7203954,477339,1490701,526722,315181,10013897,45.33,5.47
Tender_4355,5218782,2234459,524218,159996,221718,8359173,40.67,5.93
Tender_4356,9982945,2149128,274667,635264,149491,13191495,45.0,5.5
Tender_4357,3316722,192389,497817,765930,497647,5270505,38.67,6.13
Tender_4358,3918745,1446768,54468,304590,316125,6040696,34.67,6.53
Tender_4359,2809477,2390444,579620,348800,70132,6198473,47.67,5.23
Tender_4360,7619818,1016823,315876,628569,219079,9800165,34.67,6.53
Tender_4361,2972506,1906768,2778165,742399,155347,8555185,40.67,5.93
Tender_4362,5183987,3022247,527402,297841,493470,9524947,36.33,6.37
Tender_4363,5370299,362627,974810,87609,156212,6951557,27.33,7.27
Tender_4364,6222967,4323782,2853464,585827,187622,14173662,46.67,5.33
Tender_4365,773562,211830,901523,448673,161770,2497358,34.67,6.53
Tender_4366,3920446,3212071,1178011,828599,130614,9269741,51.33,4.87
Tender_4367,8650043,2336968,220539,302965,247098,11757613,27.0,7.3
Tender_4368,9897317,1567833,1939014,550598,226949,14181711,54.0,4.6
Tender_4369,3703084,1818392,2171027,113680,389460,8195643,44.0,5.6
Tender_4370,5310677,1950365,314886,971319,495637,9042884,33.0,6.7
Tender_4371,8275443,3035458,1158958,972941,314703,13757503,48.0,5.2
Tender_4372,7320480,4293145,801987,161319,340602,12917533,36.0,6.4
Tender_4373,4897820,2477973,1852100,210862,147964,9586719,42.0,5.8
Tender_4374,5579268,727464,2873343,971972,298631,10450678,49.0,5.1
Tender_4375,3275272,3086609,1715224,501130,264108,8842343,50.0,5.0
Tender_4376,3346946,1114775,1087761,571247,315367,6436096,32.0,6.8
Tender_4377,2737599,4713416,771024,811961,330009,9364009,28.33,7.17
Tender_4378,5554424,1131889,2110644,706357,114889,9618203,23.33,7.67
Tender_4379,3542615,2069882,1366987,560372,478646,8018502,30.67,6.93
Tender_4380,8134503,2199849,2426992,69310,234054,13064708,35.67,6.43
Tender_4381,8175252,1583869,836814,512012,56713,11164660,30.0,7.0
Tender_4382,5165566,4648332,1158873,680855,456832,12110458,48.33,5.17
Tender_4383,3230470,4412554,2201684,330933,381710,10557351,55.33,4.47
Tender_4384,2845121,1042532,2037408,115643,329391,6370095,45.0,5.5
Tender_4385,7099259,3139172,1393676,339990,312746,12284843,47.33,5.27
Tender_4386,7617179,803327,1579703,860193,236289,11096691,47.0,5.3
Tender_4387,1259109,2443363,2906992,184697,76368,6870529,36.33,6.37
Tender_4388,6581170,3804412,1054363,985226,498334,12923505,57.33,4.27
Tender_4389,5029812,2121668,1416140,596906,74652,9239178,32.0,6.8
Tender_4390,9400629,4857599,2835088,238395,137325,17469036,43.67,5.63
Tender_4391,4487027,4925565,1488895,321468,475404,11698359,30.67,6.93
Tender_4392,4248415,178198,2642628,610928,364522,8044691,38.67,6.13
Tender_4393,5971143,2833132,2128926,610867,375221,11919289,34.67,6.53
Tender_4394,2243951,1975943,2312632,303009,374476,7210011,38.67,6.13
Tender_4395,5009541,3994924,1926487,141713,77693,11150358,41.33,5.87
Tender_4396,6229196,4965598,2700076,373452,304388,14572710,39.0,6.1
Tender_4397,5007609,4954527,2957653,337537,284243,13541569,37.0,6.3
Tender_4398,6987866,4875516,2490230,764596,268196,15386404,41.33,5.87
Tender_4399,2454117,986629,2502720,497900,235617,6676983,45.33,5.47
Tender_4400,6739524,2999890,1877766,608368,333435,12558983,47.67,5.23
Tender_4401,870516,2908575,1069863,242620,122934,5214508,34.67,6.53
Tender_4402,5616616,4248016,717103,770170,329791,11681696,27.33,7.27
Tender_4403,5951174,1354107,1034933,765573,77602,9183389,47.33,5.27
Tender_4404,4038309,4732061,2238005,805368,385881,12199624,36.0,6.4
Tender_4405,8642926,4151537,1884093,888541,291107,15858204,38.0,6.2
Tender_4406,6294446,3345545,1839299,111913,442499,12033702,25.33,7.47
Tender_4407,6156043,4714810,1311182,330821,126338,12639194,50.0,5.0
Tender_4408,6068692,2634968,771053,950894,312036,10737643,34.0,6.6
Tender_4409,9284149,934316,2445439,70292,176581,12910777,44.33,5.57
Tender_4410,8591443,4477339,1965107,135411,245151,15414451,48.67,5.13
Tender_4411,5873246,958370,2829029,971874,335221,10967740,40.33,5.97
Tender_4412,9788877,3655026,1144289,912494,276286,15776972,26.67,7.33
Tender_4413,1847239,1168826,2692346,622045,281801,6612257,25.33,7.47
Tender_4414,9082026,4757982,702470,62632,206442,14811552,27.67,7.23
Tender_4415,9699117,1670245,699708,740686,124179,12933935,28.33,7.17
Tender_4416,1247160,3353817,1227136,565175,320885,6714173,50.0,5.0
Tender_4417,3886482,1065499,1353642,692482,68492,7066597,39.0,6.1
Tender_4418,4692860,1767489,425897,343580,427428,7657254,41.0,5.9
Tender_4419,8114449,3404385,1910027,674666,228001,14331528,30.0,7.0
Tender_4420,7904462,1295912,1518701,584464,490527,11794066,24.0,7.6
Tender_4421,4428681,2284236,918601,59728,323912,8015158,27.33,7.27
Tender_4422,4788662,2062444,2556719,759885,326042,10493752,50.0,5.0
Tender_4423,9884573,2549186,2970025,912160,277955,16593899,32.0,6.8
Tender_4424,6062340,1093979,1829972,64941,347223,9398455,39.67,6.03
Tender_4425,9509132,4925483,2074272,718257,105589,17332733,21.33,7.87
Tender_4426,5809836,810108,2006636,483259,224236,9334075,33.67,6.63
Tender_4427,3749673,3985106,1568459,417518,66813,9787569,26.67,7.33
Tender_4428,1960200,1770245,970848,699715,493151,5894159,31.33,6.87
Tender_4429,2274903,4914645,1781197,442546,473402,9886693,44.67,5.53
Tender_4430,1379009,2781113,630812,285049,150921,5226904,40.33,5.97
Tender_4431,3943125,4838691,549821,315148,51976,9698761,37.67,6.23
Tender_4432,1117070,2021123,82515,853647,347900,4422255,31.67,6.83
Tender_4433,9140779,1374100,644283,541792,460027,12160981,42.0,5.8
Tender_4434,3684023,3123903,2084633,646735,95890,9635184,40.0,6.0
Tender_4435,2630840,2663267,1005938,936601,378482,7615128,45.67,5.43
Tender_4436,1575428,2334291,1456629,416064,173574,5955986,40.0,6.0
Tender_4437,3326469,337064,2361022,774565,296311,7095431,45.33,5.47
Tender_4438,1956415,2910500,314699,556669,93344,5831627,35.0,6.5
Tender_4439,7360223,2782989,303261,454495,434867,11335835,46.0,5.4
Tender_4440,1897851,2348527,1898990,961372,495503,7602243,40.33,5.97
Tender_4441,7790674,3336851,2958072,392692,137993,14616282,29.0,7.1
Tender_4442,7239371,2082962,2533911,125089,329825,12311158,34.0,6.6
Tender_4443,2538618,1275520,303131,948794,175140,5241203,48.67,5.13
Tender_4444,6180429,827896,676701,275325,308404,8268755,25.67,7.43
Tender_4445,1734857,4745435,1280489,688906,368777,8818464,39.33,6.07
Tender_4446,9841159,1627904,2081964,508521,70002,14129550,41.0,5.9
Tender_4447,7843524,3820991,1598314,103621,73506,13439956,49.0,5.1
Tender_4448,3671467,273612,1765556,150384,60483,5921502,47.67,5.23
Tender_4449,1876111,182549,2051514,276153,128795,4515122,32.33,6.77
Tender_4450,705247,3377677,2681393,148852,306684,7219853,30.0,7.0
Tender_4451,2683102,1266084,73071,286313,148846,4457416,47.33,5.27
Tender_4452,8879086,3701033,2983530,184637,429633,16177919,19.33,8.07
Tender_4453,4369334,4744616,2017675,144368,274809,11550802,27.0,7.3
Tender_4454,3865631,3636717,2833726,80492,485055,10901621,31.0,6.9
Tender_4455,1780754,894858,2078733,559724,167169,5481238,20.67,7.93
Tender_4456,2607223,460140,202324,710183,461473,4441343,23.0,7.7
Tender_4457,7532793,4782702,825864,63276,291650,13496285,48.33,5.17
Tender_4458,5666880,2610840,336048,824967,383073,9821808,54.0,4.6
Tender_4459,2570407,2592553,1151830,944656,361222,7620668,31.67,6.83
Tender_4460,8598699,4058971,2071018,286050,166579,15181317,48.33,5.17
Tender_4461,1802261,3612740,1137748,228693,229388,7010830,28.33,7.17
Tender_4462,228566,418776,1563436,345996,410501,2967275,49.0,5.1
Tender_4463,1126747,4196054,1374941,533300,336497,7567539,42.0,5.8
Tender_4464,7658693,4234471,193893,190275,450725,12728057,38.67,6.13
Tender_4465,4955210,4367320,386297,975705,353727,11038259,43.0,5.7
Tender_4466,9368741,4997751,2773713,526732,199449,17866386,30.33,6.97
Tender_4467,9403952,4521269,1193543,775701,181153,16075618,48.33,5.17
Tender_4468,9233235,4821457,2369041,171939,405984,17001656,26.0,7.4
Tender_4469,8239184,3332728,2711575,881770,97768,15263025,58.33,4.17
Tender_4470,1467103,1419076,638137,203873,186110,3914299,19.0,8.1
Tender_4471,360408,4467260,910836,720333,175820,6634657,41.33,5.87
Tender_4472,6177037,3569353,1203876,184255,292644,11427165,53.0,4.7
Tender_4473,4491063,4280228,2805255,365337,130785,12072668,46.0,5.4
Tender_4474,8972537,2545068,1921945,471841,226348,14137739,29.0,7.1
Tender_4475,5094181,1930496,2594604,878239,362731,10860251,51.67,4.83
Tender_4476,822462,2042620,2415608,290234,315226,5886150,44.0,5.6
Tender_4477,4796501,1760979,990693,912501,181881,8642555,42.0,5.8
Tender_4478,4326246,4735184,565568,864755,354911,10846664,35.0,6.5
Tender_4479,9530259,4467756,2288017,669194,195289,17150515,29.67,7.03
Tender_4480,1090425,2976301,1180059,852377,456545,6555707,37.0,6.3
Tender_4481,1160661,1403018,1447818,375339,414143,4800979,28.0,7.2
Tender_4482,9289453,2786928,2843003,603182,107339,15629905,26.67,7.33
Tender_4483,6584261,4764868,2963437,325096,360858,14998520,31.0,6.9
Tender_4484,7063494,4393030,1899240,139197,123364,13618325,47.33,5.27
Tender_4485,7088373,590408,1410001,636968,120296,9846046,40.0,6.0
Tender_4486,5749070,2673958,1234934,358049,482379,10498390,36.67,6.33
Tender_4487,8908390,4885867,839785,642837,317240,15594119,43.67,5.63
Tender_4488,1496344,3442177,415533,578571,346885,6279510,32.67,6.73
Tender_4489,5477410,1455974,1929864,507434,124676,9495358,23.33,7.67
Tender_4490,3703923,3087774,284951,702327,451755,8230730,25.0,7.5
Tender_4491,4362905,1498528,1851051,943491,336035,8992010,29.0,7.1
Tender_4492,6542163,3074092,2127369,287014,400219,12430857,46.0,5.4
Tender_4493,2811476,2799253,2381023,379872,225016,8596640,39.0,6.1
Tender_4494,2649521,4771816,876791,55283,436858,8790269,42.33,5.77
Tender_4495,4253841,346125,1671704,202650,497291,6971611,41.33,5.87
Tender_4496,4241651,2175277,2084751,609409,66582,9177670,19.0,8.1
Tender_4497,3737134,1048317,1834514,943539,141698,7705202,46.33,5.37
Tender_4498,6658788,2846052,120897,760168,301676,10687581,58.67,4.13
Tender_4499,4830614,1952500,2905043,434847,194366,10317370,37.67,6.23
Tender_4500,7404204,2911254,1693180,54141,433689,12496468,43.33,5.67
Tender_4501,9813508,1906016,2448528,157160,411537,14736749,19.33,8.07
Tender_4502,6063572,643242,1849056,324318,362284,9242472,47.0,5.3
Tender_4503,4688040,1732019,2230839,506977,475759,9633634,49.0,5.1
Tender_4504,9719219,719219,1958797,600673,187615,13185523,33.0,6.7
Tender_4505,5416033,1879196,2461276,690260,77026,10523791,23.33,7.67
Tender_4506,7430063,3086971,2635718,528717,266403,13947872,39.33,6.07
Tender_4507,6234686,1188435,578346,509266,418925,8929658,39.67,6.03
Tender_4508,9647040,659426,2217399,959578,438440,13921883,44.67,5.53
Tender_4509,2608334,2638901,1651929,277485,66762,7243411,37.0,6.3
Tender_4510,453593,4347344,1064662,418425,255696,6539720,54.67,4.53
Tender_4511,6285409,2901572,264440,263193,285182,9999796,27.33,7.27
Tender_4512,5243129,4157239,2290896,768583,491080,12950927,32.67,6.73
Tender_4513,8974651,2941420,767766,486554,457282,13627673,44.33,5.57
Tender_4514,9553850,737065,1400131,960565,324273,12975884,31.33,6.87
Tender_4515,8991997,3875378,978944,841871,174150,14862340,40.67,5.93
Tender_4516,6276665,2343631,2762503,781007,292860,12456666,40.0,6.0
Tender_4517,1062652,2069208,2652825,886248,476949,7147882,33.0,6.7
Tender_4518,8043705,633607,197591,590446,73128,9538477,29.0,7.1
Tender_4519,3762924,1655350,128145,495146,168992,6210557,40.33,5.97
Tender_4520,2721187,3544366,1522479,769262,374247,8931541,31.67,6.83
Tender_4521,6377645,1181314,1164907,448608,153848,9326322,28.67,7.13
Tender_4522,7972428,758975,975831,501956,463757,10672947,45.33,5.47
Tender_4523,1669445,3854899,315933,896671,368600,7105548,33.0,6.7
Tender_4524,7057622,2165027,1634912,810189,252157,11919907,40.0,6.0
Tender_4525,3299254,976624,2777914,680390,424779,8158961,44.67,5.53
Tender_4526,1155367,2604341,1916040,485487,341451,6502686,47.0,5.3
Tender_4527,8268216,3148299,2948638,116693,308497,14790343,38.33,6.17
Tender_4528,8196654,3890514,80909,515133,429696,13112906,53.67,4.63
Tender_4529,2978833,1617886,1180071,708392,267905,6753087,47.0,5.3
Tender_4530,7167233,3685895,260170,91604,290229,11495131,42.33,5.77
Tender_4531,2358135,3182311,1159552,240510,101338,7041846,34.67,6.53
Tender_4532,6314465,2630030,2410104,546548,141413,12042560,47.33,5.27
Tender_4533,3327442,1662722,649617,945286,126753,6711820,44.33,5.57
Tender_4534,3723412,2814538,747175,540352,151552,7977029,50.33,4.97
Tender_4535,2370072,4413460,739010,858445,289691,8670678,52.67,4.73
Tender_4536,867603,3659257,1109818,982373,168573,6787624,50.67,4.93
Tender_4537,6991323,3394588,250506,416449,350536,11403402,41.33,5.87
Tender_4538,7211044,125909,2809833,828733,122755,11098274,38.0,6.2
Tender_4539,2655503,1084284,1878245,648979,132907,6399918,26.67,7.33
Tender_4540,7785149,4882083,1873793,130996,69046,14741067,28.33,7.17
Tender_4541,2436952,2309965,1812449,141145,159681,6860192,38.0,6.2
Tender_4542,5905127,3464307,135832,71157,384199,9960622,41.33,5.87
Tender_4543,762294,962549,1748321,523266,78961,4075391,36.33,6.37
Tender_4544,8368597,1113131,1109980,771377,294704,11657789,31.33,6.87
Tender_4545,389167,3654474,238372,224659,245542,4752214,34.0,6.6
Tender_4546,1363694,104120,1628251,864700,62217,4022982,36.0,6.4
Tender_4547,2469815,4616440,1156831,876867,430813,9550766,37.33,6.27
Tender_4548,824986,1061216,1656877,319179,386582,4248840,44.0,5.6
Tender_4549,409732,254356,722544,878584,240459,2505675,39.33,6.07
Tender_4550,9424333,4165033,2003985,601251,469877,16664479,41.33,5.87
Tender_4551,4969027,2598447,2259974,274534,428626,10530608,37.67,6.23
Tender_4552,967428,2925453,2375937,380904,299772,6949494,47.67,5.23
Tender_4553,8179049,1438393,1833407,161566,79676,11692091,25.33,7.47
Tender_4554,6329465,3074042,1757415,837424,120386,12118732,31.0,6.9
Tender_4555,8905451,2652714,894255,796734,271769,13520923,28.0,7.2
Tender_4556,8786346,4677668,2214073,950800,491789,17120676,33.33,6.67
Tender_4557,2898802,3491417,95959,821534,273506,7581218,42.67,5.73
Tender_4558,2386619,1087637,68662,485979,71283,4100180,43.67,5.63
Tender_4559,2645053,2867546,905819,551418,297470,7267306,52.0,4.8
Tender_4560,8235902,448368,870745,839708,495529,10890252,40.67,5.93
Tender_4561,2331072,4549443,485723,55434,346029,7767701,24.0,7.6
Tender_4562,5441003,3129910,859415,160294,69433,9660055,28.0,7.2
Tender_4563,8800012,2838354,2027411,77431,140259,13883467,31.67,6.83
Tender_4564,5582654,1031475,1590296,299646,372633,8876704,35.33,6.47
Tender_4565,3955261,874949,2278197,762342,324136,8194885,42.67,5.73
Tender_4566,1262230,511013,2938300,567421,71407,5350371,41.0,5.9
Tender_4567,8503888,4611583,1967058,541309,291632,15915470,30.67,6.93
Tender_4568,8824057,249253,2164796,398489,340517,11977112,18.0,8.2
Tender_4569,5809630,1733108,249789,489048,94961,8376536,57.33,4.27
Tender_4570,8673543,225130,1984075,436303,134341,11453392,21.33,7.87
Tender_4571,8097282,3465399,1948127,606724,435539,14553071,33.33,6.67
Tender_4572,8674449,1072717,1674534,836995,399313,12658008,36.33,6.37
Tender_4573,8311044,3008490,1914638,501779,91870,13827821,39.67,6.03
Tender_4574,3643481,2579551,1897288,750410,259332,9130062,42.33,5.77
Tender_4575,4782044,4113371,2838158,704595,63193,12501361,25.67,7.43
Tender_4576,1091127,884626,1526257,796117,499824,4797951,38.33,6.17
Tender_4577,6092819,608565,2314442,385590,211168,9612584,52.33,4.77
Tender_4578,4106679,2778109,1060140,667325,464604,9076857,47.0,5.3
Tender_4579,9261133,3983308,511373,942595,424719,15123128,32.33,6.77
Tender_4580,6842708,4606209,908436,811490,355897,13524740,37.0,6.3
Tender_4581,8242500,4002820,2874346,337241,70310,15527217,48.67,5.13
Tender_4582,6982411,609141,2914499,470160,115165,11091376,35.33,6.47
Tender_4583,7568771,2178762,2716241,552947,465612,13482333,41.0,5.9
Tender_4584,7844053,3972156,437672,779133,344564,13377578,26.33,7.37
Tender_4585,404460,976812,655711,908749,389989,3335721,38.67,6.13
Tender_4586,3362086,1825930,2517691,269333,450384,8425424,30.33,6.97
Tender_4587,8266153,1030674,2100199,632664,357221,12386911,45.0,5.5
Tender_4588,3384513,841303,2190737,918018,135929,7470500,42.33,5.77
Tender_4589,7619947,2691400,1566700,986240,451517,13315804,50.67,4.93
Tender_4590,9690249,1221331,1458566,726665,269321,13366132,33.33,6.67
Tender_4591,6992839,3925009,688998,803958,492892,12903696,28.33,7.17
Tender_4592,8178185,746404,2472804,754770,226381,12378544,23.33,7.67
Tender_4593,2575327,474566,1843872,407533,77513,5378811,40.33,5.97
Tender_4594,9518983,612012,1159938,244749,68994,11604676,36.33,6.37
Tender_4595,856892,1759232,2252602,831922,170829,5871477,25.67,7.43
Tender_4596,3604045,3612996,2848195,231951,377510,10674697,45.0,5.5
Tender_4597,7057755,3333133,2635103,161357,345324,13532672,49.0,5.1
Tender_4598,7638301,3716078,2772739,657537,493852,15278507,26.0,7.4
Tender_4599,2255463,176206,961410,525047,84535,4002661,46.33,5.37
Tender_4600,9847499,3741446,2520368,494489,239906,16843708,26.0,7.4
Tender_4601,9875828,1859862,2355022,469948,249153,14809813,44.0,5.6
Tender_4602,9872196,1374515,2168332,898929,336527,14650499,37.33,6.27
Tender_4603,4408672,4760659,2933754,338714,154049,12595848,42.33,5.77
Tender_4604,6980446,4061572,2974057,837576,212012,15065663,40.0,6.0
Tender_4605,6393852,4494424,2675145,427696,157871,14148988,35.67,6.43
Tender_4606,754029,4776936,1761697,909412,196186,8398260,46.0,5.4
Tender_4607,1679934,646928,574258,634620,286202,3821942,36.0,6.4
Tender_4608,3325616,3047260,527763,943615,102647,7946901,41.33,5.87
Tender_4609,3440781,4999608,908531,106111,474924,9929955,45.67,5.43
Tender_4610,5846180,2389277,2520522,540203,397972,11694154,31.67,6.83
Tender_4611,8305592,2923721,1549192,140757,112031,13031293,32.33,6.77
Tender_4612,9029708,3696050,1403305,679339,158941,14967343,19.67,8.03
Tender_4613,2643426,615208,1189871,843672,215262,5507439,47.0,5.3
Tender_4614,3125229,3407607,1015068,954937,392337,8895178,29.33,7.07
Tender_4615,3504688,4899109,1252440,983700,106847,10746784,33.33,6.67
Tender_4616,4760098,2945512,289325,941983,151564,9088482,33.0,6.7
Tender_4617,7933752,2819653,1412256,909537,359250,13434448,49.33,5.07
Tender_4618,813848,4866436,1172930,114436,235183,7202833,24.0,7.6
Tender_4619,9295876,1002149,2810806,478137,419129,14006097,29.0,7.1
Tender_4620,3893726,2871306,2873244,343829,368179,10350284,30.0,7.0
Tender_4621,5335140,1590055,379906,400549,127176,7832826,28.33,7.17
Tender_4622,1017490,2333512,1736556,535189,484598,6107345,33.33,6.67
Tender_4623,7493324,1612891,2817716,798475,308162,13030568,40.0,6.0
Tender_4624,2745879,4076673,824505,106397,442389,8195843,27.67,7.23
Tender_4625,6509110,2730777,1410546,91526,463112,11205071,33.33,6.67
Tender_4626,2561736,593714,1558019,212875,186214,5112558,37.0,6.3
Tender_4627,6383858,356997,2370653,341473,250896,9703877,43.33,5.67
Tender_4628,4085141,953416,285268,465958,337294,6127077,28.67,7.13
Tender_4629,6851317,3257442,2196353,210525,101079,12616716,28.67,7.13
Tender_4630,5441750,974221,350589,661789,271571,7699920,35.67,6.43
Tender_4631,5383117,2924375,2128106,434449,129636,10999683,18.33,8.17
Tender_4632,1428773,1754006,2984111,745285,52330,6964505,43.33,5.67
Tender_4633,4749671,3381991,2168206,945466,131150,11376484,27.0,7.3
Tender_4634,9239484,2250049,1730992,796964,277823,14295312,43.33,5.67
Tender_4635,8146989,2438855,2554967,450263,322039,13913113,31.33,6.87
Tender_4636,8421175,1957470,2085968,447625,314005,13226243,42.0,5.8
Tender_4637,7584874,653971,2051020,580892,420222,11290979,34.0,6.6
Tender_4638,5120645,3298154,2883488,971672,163120,12437079,36.33,6.37
Tender_4639,5883413,1476915,675993,76068,282886,8395275,56.67,4.33
Tender_4640,9764324,1954951,2345773,427327,490876,14983251,43.0,5.7
Tender_4641,9699290,225401,2287446,125810,98681,12436628,40.0,6.0
Tender_4642,4823643,318905,1963480,121927,233637,7461592,43.0,5.7
Tender_4643,2237025,2181065,992812,913575,302514,6626991,54.0,4.6
Tender_4644,8609382,153655,1861876,710628,462918,11798459,47.67,5.23
Tender_4645,9196695,348492,166046,656886,98286,10466405,45.67,5.43
Tender_4646,4015586,2683497,1576550,368259,476733,9120625,23.67,7.63
Tender_4647,6559799,3043457,492024,528191,190483,10813954,33.0,6.7
Tender_4648,8846922,1530240,372012,207066,61206,11017446,26.0,7.4
Tender_4649,288151,462340,57686,382951,262087,1453215,35.67,6.43
Tender_4650,9288949,4518639,2880034,741193,367228,17796043,45.33,5.47
Tender_4651,9932722,1432350,891137,879881,138785,13274875,44.33,5.57
Tender_4652,9022394,1800902,1533744,672009,449182,13478231,51.0,4.9
Tender_4653,8991623,2721841,938560,827151,206204,13685379,39.67,6.03
Tender_4654,1237751,127918,1545915,353119,488428,3753131,32.0,6.8
Tender_4655,3438594,3277102,2407950,590213,309782,10023641,42.67,5.73
Tender_4656,2988283,4402214,1037310,515057,113033,9055897,34.0,6.6
Tender_4657,530722,4585641,2623905,894466,108030,8742764,37.33,6.27
Tender_4658,7562740,4397147,2628560,556407,125053,15269907,38.67,6.13
Tender_4659,6743193,4696233,1423669,809753,179753,13852601,45.33,5.47
Tender_4660,4983642,2031483,609503,454023,227274,8305925,25.33,7.47
Tender_4661,5105299,659470,1405853,174732,100791,7446145,27.0,7.3
Tender_4662,9037896,833365,2154289,225136,293383,12544069,36.67,6.33
Tender_4663,1291183,2528305,306369,504415,169966,4800238,29.33,7.07
Tender_4664,8182814,3505169,269499,753731,227529,12938742,45.67,5.43
Tender_4665,6161714,1761342,159698,588141,350663,9021558,43.0,5.7
Tender_4666,6154696,4368033,2427468,408069,222691,13580957,31.0,6.9
Tender_4667,2373994,3553582,1865949,285513,307757,8386795,32.0,6.8
Tender_4668,5831198,4256363,861498,126059,469310,11544428,33.67,6.63
Tender_4669,4061162,3520835,408292,346635,131009,8467933,42.33,5.77
Tender_4670,1312692,4645138,2257195,773355,212801,9201181,48.0,5.2
Tender_4671,3261501,2243050,222747,787121,447654,6962073,43.0,5.7
Tender_4672,6093912,2325619,182936,793342,471233,9867042,43.67,5.63
Tender_4673,5594484,2401263,2452386,53751,201024,10702908,26.0,7.4
Tender_4674,2525151,652872,2279463,976604,447034,6881124,30.0,7.0
Tender_4675,5584739,1361514,2713070,776134,366152,10801609,37.67,6.23
Tender_4676,672831,1042523,1745263,856366,150954,4467937,42.0,5.8
Tender_4677,662118,660445,1069853,53098,467677,2913191,45.0,5.5
Tender_4678,3428878,4151564,878383,83254,289325,8831404,46.67,5.33
Tender_4679,1052049,529540,374476,239145,253587,2448797,42.67,5.73
Tender_4680,9328384,3305146,1748407,293826,388458,15064221,49.0,5.1
Tender_4681,9860360,1339851,1685590,893325,149748,13928874,35.67,6.43
Tender_4682,8018534,1309260,1504316,544859,84940,11461909,43.33,5.67
Tender_4683,3562284,1031090,2648513,916708,428486,8587081,48.0,5.2
Tender_4684,8179240,4291525,993647,907625,156075,14528112,23.33,7.67
Tender_4685,7072202,4651541,1948387,498684,90918,14261732,29.67,7.03
Tender_4686,1050738,2683261,964857,549787,79427,5328070,19.0,8.1
Tender_4687,3127175,1160122,1381260,273461,334242,6276260,32.0,6.8
Tender_4688,8091797,3561873,261474,505101,243768,12664013,43.67,5.63
Tender_4689,8896602,132196,433056,80184,384715,9926753,44.67,5.53
Tender_4690,8151821,1748790,187105,436465,233597,10757778,31.67,6.83
Tender_4691,1141283,1367347,928754,139142,276079,3852605,30.33,6.97
Tender_4692,3537345,221441,2228253,516147,74499,6577685,19.0,8.1
Tender_4693,4392734,159261,226042,121388,213244,5112669,41.67,5.83
Tender_4694,2435474,1875648,96852,295507,355273,5058754,51.67,4.83
Tender_4695,2106592,4887121,1725048,944657,356642,10020060,47.67,5.23
Tender_4696,5883034,280744,449145,457520,94626,7165069,41.0,5.9
Tender_4697,8603831,1437948,2947838,347447,308760,13645824,46.33,5.37
Tender_4698,3713116,1050917,2554781,340145,257465,7916424,31.67,6.83
Tender_4699,6980983,2905502,1455582,403574,231626,11977267,28.33,7.17
Tender_4700,3693359,2696116,2150383,688553,205449,9433860,54.33,4.57
Tender_4701,866356,1244494,2907313,832822,396127,6247112,38.0,6.2
Tender_4702,3506828,3050887,2039449,236525,389806,9223495,23.33,7.67
Tender_4703,2307098,2712008,885620,305126,375883,6585735,35.67,6.43
Tender_4704,8771617,1378778,80604,495377,208318,10934694,39.0,6.1
Tender_4705,5986041,4352069,573147,320127,86008,11317392,47.0,5.3
Tender_4706,9004178,2178045,2576713,899566,285644,14944146,40.67,5.93
Tender_4707,7399919,4778474,806284,643513,296980,13925170,26.0,7.4
Tender_4708,8008554,952808,1305916,682340,280494,11230112,33.0,6.7
Tender_4709,4752826,1024189,2815892,561656,243659,9398222,42.33,5.77
Tender_4710,3955494,1294319,1214475,811815,331981,7608084,24.67,7.53
Tender_4711,6652247,1065279,564622,667581,123043,9072772,22.67,7.73
Tender_4712,578484,377974,2392403,615743,171472,4136076,40.33,5.97
Tender_4713,5098711,2913667,2640972,427676,103171,11184197,41.0,5.9
Tender_4714,8653342,4234231,707034,134774,273905,14003286,44.33,5.57
Tender_4715,9106766,211139,1050763,181536,224407,10774611,53.67,4.63
Tender_4716,8934983,819210,1221101,361933,330314,11667541,39.33,6.07
Tender_4717,4137483,1664589,2284682,472243,269747,8828744,28.33,7.17
Tender_4718,4248744,2289328,771237,121690,191427,7622426,37.0,6.3
Tender_4719,6779571,2454314,687631,797794,291057,11010367,47.33,5.27
Tender_4720,2505805,1373820,775062,222712,73855,4951254,48.0,5.2
Tender_4721,9403355,1756504,1292252,833260,478906,13764277,33.67,6.63
Tender_4722,2115297,3427232,1986262,987496,144071,8660358,50.33,4.97
Tender_4723,7561510,160647,401662,409309,274723,8807851,29.0,7.1
Tender_4724,5512160,1292249,1511782,413455,64482,8794128,38.0,6.2
Tender_4725,307657,2776381,2794399,681596,94287,6654320,23.67,7.63
Tender_4726,7470512,3582743,1417227,381892,459473,13311847,44.33,5.57
Tender_4727,866699,4210003,2988449,785969,276036,9127156,39.67,6.03
Tender_4728,5124694,2073703,551134,485666,337024,8572221,34.33,6.57
Tender_4729,7996785,1603482,1386865,675056,73278,11735466,45.0,5.5
Tender_4730,1292334,1514891,441988,244814,182034,3676061,44.33,5.57
Tender_4731,9165503,1130991,1465174,886695,299323,12947686,28.33,7.17
Tender_4732,8774016,3887883,2704468,308343,468600,16143310,39.0,6.1
Tender_4733,8874953,967571,716524,120720,189429,10869197,33.33,6.67
Tender_4734,413659,1476764,2201682,596282,154330,4842717,48.33,5.17
Tender_4735,6739889,2193513,1561553,891587,265627,11652169,53.0,4.7
Tender_4736,5994684,1666183,1241411,287721,355499,9545498,30.33,6.97
Tender_4737,1407822,540536,2391449,923273,386657,5649737,58.0,4.2
Tender_4738,4099502,2811783,2482047,168187,201012,9762531,53.0,4.7
Tender_4739,1613668,2871318,1538123,978270,494674,7496053,35.0,6.5
Tender_4740,2242986,2668839,2638354,799105,414306,8763590,17.0,8.3
Tender_4741,4822245,115251,2242108,834959,250207,8264770,16.0,8.4
Tender_4742,2940755,1737247,1896068,824416,343780,7742266,30.33,6.97
Tender_4743,9677971,2445851,441877,965454,81636,13612789,47.33,5.27
Tender_4744,7018029,2023576,422761,331554,239815,10035735,32.0,6.8
Tender_4745,7716942,3261597,2660751,896377,200663,14736330,35.67,6.43
Tender_4746,3563111,4382996,1767621,233352,444070,10391150,47.33,5.27
Tender_4747,461923,4631704,2707121,943120,389830,9133698,41.33,5.87
Tender_4748,7694977,3596927,2602930,442134,403148,14740116,38.33,6.17
Tender_4749,4442818,4905476,179635,451431,259316,10238676,30.33,6.97
Tender_4750,6760826,985338,578971,88982,170294,8584411,36.33,6.37
Tender_4751,9398737,2445499,541759,250952,226638,12863585,29.67,7.03
Tender_4752,6727289,4716578,967615,427259,419861,13258602,31.0,6.9
Tender_4753,3627937,564773,2240812,151851,193490,6778863,22.67,7.73
Tender_4754,9236009,1902880,1824595,817508,460490,14241482,42.67,5.73
Tender_4755,6533286,331960,2326349,639292,94840,9925727,40.67,5.93
Tender_4756,5174213,3390199,1712207,277266,220637,10774522,43.33,5.67
Tender_4757,6723484,3534550,343205,545075,178380,11324694,47.0,5.3
Tender_4758,1484457,3221811,2710246,876269,73798,8366581,32.0,6.8
Tender_4759,1220278,3426255,2757898,982953,214043,8601427,33.67,6.63
Tender_4760,7846186,4949021,482586,263699,149906,13691398,38.67,6.13
Tender_4761,9402348,1769339,2966676,304841,394251,14837455,49.0,5.1
Tender_4762,1858893,265742,2328007,699721,326653,5479016,45.67,5.43
Tender_4763,3082231,327202,1032585,158595,275629,4876242,39.33,6.07
Tender_4764,7774412,423769,2419447,576173,176916,11370717,41.33,5.87
Tender_4765,7865417,2177168,1334235,319638,301640,11998098,31.33,6.87
Tender_4766,4512487,4363286,2666980,732071,293519,12568343,35.67,6.43
Tender_4767,2253680,4134684,2145999,971251,136585,9642199,37.67,6.23
Tender_4768,8105142,2783573,1394468,755448,246394,13285025,46.0,5.4
Tender_4769,7322921,2879274,659973,602733,163715,11628616,32.33,6.77
Tender_4770,5659434,3582806,2106487,484681,440930,12274338,31.33,6.87
Tender_4771,5567417,3869073,2885989,72774,361567,12756820,26.67,7.33
Tender_4772,8796156,3325051,469729,985842,387200,13963978,36.0,6.4
Tender_4773,9471864,773281,655153,502448,492021,11894767,46.33,5.37
Tender_4774,8737019,2065169,2486866,121438,134814,13545306,35.0,6.5
Tender_4775,2389443,2330709,2882057,762591,424972,8789772,22.0,7.8
Tender_4776,3894612,1627180,83026,394346,479763,6478927,33.33,6.67
Tender_4777,1291960,4767667,1227168,724601,346067,8357463,31.0,6.9
Tender_4778,7067197,1195611,712794,68207,84152,9127961,17.33,8.27
Tender_4779,2632490,2038293,1253655,338775,401718,6664931,41.0,5.9
Tender_4780,8296291,1718964,120729,599299,209715,10944998,25.33,7.47
Tender_4781,776786,2394845,2242455,428644,278047,6120777,42.0,5.8
Tender_4782,5128910,2366186,784173,372416,496246,9147931,29.67,7.03
Tender_4783,1890525,2074206,2138087,587895,369958,7060671,45.0,5.5
Tender_4784,4976499,275974,1244099,552638,273073,7322283,34.0,6.6
Tender_4785,2195822,2206598,1653016,377368,325474,6758278,36.0,6.4
Tender_4786,8954004,4082082,491514,948816,232120,14708536,36.67,6.33
Tender_4787,6292269,855971,2612937,268497,90626,10120300,34.67,6.53
Tender_4788,7181806,2683222,2268763,668081,123762,12925634,40.33,5.97
Tender_4789,2345028,1543507,562098,91447,491809,5033889,50.67,4.93
Tender_4790,4185420,4170693,1828458,81795,261084,10527450,36.33,6.37
Tender_4791,4174283,1217084,1354787,823978,455617,8025749,45.67,5.43
Tender_4792,3661250,196232,1297547,219829,304797,5679655,40.0,6.0
Tender_4793,9123561,3009279,1031147,823882,168631,14156500,31.67,6.83
Tender_4794,4170302,777878,915655,902279,358733,7124847,44.0,5.6
Tender_4795,2043332,1719861,2728814,111835,58321,6662163,41.67,5.83
Tender_4796,6933952,3091058,2037031,579801,432951,13074793,46.33,5.37
Tender_4797,8567857,2491726,896572,908589,325762,13190506,40.0,6.0
Tender_4798,3213401,921066,151603,774450,494770,5555290,42.33,5.77
Tender_4799,9945234,2538750,2597162,684042,380148,16145336,51.67,4.83
Tender_4800,986569,4875399,260101,161668,275713,6559450,34.67,6.53
Tender_4801,783882,1030038,189967,321607,358599,2684093,47.33,5.27
Tender_4802,4136499,3667137,2527551,110208,493952,10935347,51.67,4.83
Tender_4803,7788253,1084427,184650,819409,391852,10268591,37.0,6.3
Tender_4804,2557609,846010,1726715,670853,465749,6266936,41.0,5.9
Tender_4805,5346912,763781,779809,487352,184533,7562387,30.33,6.97
Tender_4806,8443160,1355921,2645433,341880,399295,13185689,52.67,4.73
Tender_4807,1190925,4529469,2564406,472599,170496,8927895,32.0,6.8
Tender_4808,4463959,2242233,398368,444847,390861,7940268,46.33,5.37
Tender_4809,2198206,1334800,999092,340079,326852,5199029,47.33,5.27
Tender_4810,6202379,2771964,2603244,239944,151164,11968695,49.67,5.03
Tender_4811,1648334,3551313,246971,370220,305483,6122321,53.0,4.7
Tender_4812,3481646,854502,1137737,640151,181952,6295988,38.33,6.17
Tender_4813,1079176,3411917,469174,347062,71761,5379090,39.0,6.1
Tender_4814,8394837,1554077,105404,124812,424082,10603212,28.0,7.2
Tender_4815,5191076,2125197,2756002,619288,132092,10823655,32.0,6.8
Tender_4816,5689509,1228823,1229138,228048,241002,8616520,52.0,4.8
Tender_4817,6359460,3477892,271337,944971,410748,11464408,38.0,6.2
Tender_4818,2668859,4570106,1688003,549555,221836,9698359,44.67,5.53
Tender_4819,779917,3609049,1023248,388803,140432,5941449,37.0,6.3
Tender_4820,334762,1295464,959491,860808,479611,3930136,21.67,7.83
Tender_4821,3522300,3182463,524384,359862,448514,8037523,28.33,7.17
Tender_4822,6083913,850190,1227450,771960,462827,9396340,48.0,5.2
Tender_4823,3036092,1716652,2006157,277653,329090,7365644,27.33,7.27
Tender_4824,538001,4024786,1704466,94326,493984,6855563,40.0,6.0
Tender_4825,6350331,4100416,2134351,538672,192232,13316002,42.0,5.8
Tender_4826,8222516,1296981,899740,800109,419641,11638987,40.33,5.97
Tender_4827,772138,4075838,132102,166507,66630,5213215,47.67,5.23
Tender_4828,9486586,3423006,257064,365816,397694,13930166,26.33,7.37
Tender_4829,3495267,136433,2619664,710430,80625,7042419,35.0,6.5
Tender_4830,9954689,3079917,485093,136406,476989,14133094,39.67,6.03
Tender_4831,2405357,3132457,1752839,519428,166074,7976155,46.0,5.4
Tender_4832,2804744,3098426,1269676,369608,381216,7923670,43.67,5.63
Tender_4833,7172427,193622,1655138,573793,238615,9833595,28.67,7.13
Tender_4834,4262086,4403312,362779,714809,164044,9907030,34.67,6.53
Tender_4835,236614,2464236,2637123,161130,124264,5623367,35.67,6.43
Tender_4836,3652394,4440272,363162,845898,189606,9491332,40.33,5.97
Tender_4837,1106311,1830613,1364488,433258,199218,4933888,50.0,5.0
Tender_4838,8532962,1002188,2405362,533389,217828,12691729,38.0,6.2
Tender_4839,8669712,225662,2960208,338168,280008,12473758,39.0,6.1
Tender_4840,4127184,1916036,1541406,665137,264734,8514497,44.33,5.57
Tender_4841,8537922,2331277,938163,671730,312493,12791585,36.67,6.33
Tender_4842,1311952,2698443,213066,864706,329467,5417634,37.67,6.23
Tender_4843,7069578,3538030,2227863,880537,440460,14156468,43.67,5.63
Tender_4844,4564423,2336643,2659583,968503,482906,11012058,23.33,7.67
Tender_4845,2675740,1906348,1806126,832721,492391,7713326,35.67,6.43
Tender_4846,4820995,581847,2003022,468815,179806,8054485,40.33,5.97
Tender_4847,6956696,3880477,1102725,826487,159959,12926344,49.0,5.1
Tender_4848,1894380,2466575,1690771,327723,218277,6597726,30.33,6.97
Tender_4849,2657967,4310990,1070344,532196,98984,8670481,44.67,5.53
Tender_4850,6120788,1559870,375477,222733,254976,8533844,46.67,5.33
Tender_4851,8395048,496301,2463038,277841,258065,11890293,43.67,5.63
Tender_4852,9183016,4079550,1272970,951874,70192,15557602,47.33,5.27
Tender_4853,2260525,3501892,1490254,505227,311687,8069585,28.67,7.13
Tender_4854,2983651,4314022,702210,460964,301324,8762171,29.67,7.03
Tender_4855,3367806,724319,2758841,137030,148526,7136522,30.33,6.97
Tender_4856,3385731,1316708,2939875,806693,323436,8772443,39.0,6.1
Tender_4857,2169175,4031500,885965,129229,274367,7490236,19.67,8.03
Tender_4858,7275239,4400096,1846851,532236,255863,14310285,44.67,5.53
Tender_4859,686736,4303908,588000,471266,288273,6338183,36.33,6.37
Tender_4860,3541606,4431398,489632,125437,150369,8738442,34.67,6.53
Tender_4861,1064100,103044,2598476,334673,467367,4567660,42.0,5.8
Tender_4862,9248786,668827,87041,567723,293349,10865726,44.67,5.53
Tender_4863,3303627,1605676,848877,65686,318619,6142485,41.0,5.9
Tender_4864,6438186,1332846,1768361,991571,329636,10860600,50.67,4.93
Tender_4865,6955913,3501628,363112,226075,264920,11311648,33.67,6.63
Tender_4866,4235803,4843111,1679546,936670,425783,12120913,31.67,6.83
Tender_4867,1539219,3062444,1454822,517601,419485,6993571,35.67,6.43
Tender_4868,1665989,841150,1176907,689086,335459,4708591,47.0,5.3
Tender_4869,5097388,527331,991123,763818,419615,7799275,41.67,5.83
Tender_4870,560948,3620857,2181815,755706,252412,7371738,37.0,6.3
Tender_4871,3053475,1525084,1291660,322257,286590,6479066,25.0,7.5
Tender_4872,1781189,2652600,1113158,723178,105406,6375531,31.33,6.87
Tender_4873,6067228,2636176,554552,858120,366219,10482295,19.67,8.03
Tender_4874,3720659,1295511,2763568,115218,425659,8320615,19.33,8.07
Tender_4875,1036842,318476,591180,317100,289227,2552825,43.33,5.67
Tender_4876,8737378,3206022,1876485,667100,105186,14592171,46.67,5.33
Tender_4877,447415,1554426,994638,600009,428656,4025144,42.0,5.8
Tender_4878,4944401,284541,731217,745895,151237,6857291,25.67,7.43
Tender_4879,1127912,1785768,2753444,881449,147102,6695675,53.0,4.7
Tender_4880,2893332,413563,2764356,456963,56209,6584423,44.33,5.57
Tender_4881,7900555,3639814,1803956,125011,368177,13837513,46.33,5.37
Tender_4882,7125211,2929758,812626,153069,392289,11412953,41.33,5.87
Tender_4883,1409692,4179671,1017634,159005,126180,6892182,33.0,6.7
Tender_4884,8030689,956753,2056549,519190,171591,11734772,41.0,5.9
Tender_4885,8401067,1316392,2675564,226549,454936,13074508,42.0,5.8
Tender_4886,9357643,4796198,1798955,330042,454970,16737808,32.0,6.8
Tender_4887,1900412,4282134,909587,883327,461883,8437343,39.67,6.03
Tender_4888,3030726,3071928,1179786,521878,147239,7951557,27.0,7.3
Tender_4889,8803212,1840163,1420497,763057,426536,13253465,39.0,6.1
Tender_4890,4392458,1934817,2413267,800310,265883,9806735,38.33,6.17
Tender_4891,4316909,2521242,1684163,874634,306137,9703085,52.67,4.73
Tender_4892,2415835,4344235,735286,878846,487563,8861765,54.67,4.53
Tender_4893,3877418,267597,1868076,814482,298313,7125886,45.33,5.47
Tender_4894,4824498,4799224,907822,929695,141047,11602286,31.67,6.83
Tender_4895,6459078,261387,1604150,628030,134748,9087393,27.33,7.27
Tender_4896,4504604,721984,2681044,696110,301730,8905472,24.67,7.53
Tender_4897,2507442,1746925,2906730,177087,405677,7743861,40.67,5.93
Tender_4898,2648611,3768902,918775,318224,260728,7915240,48.0,5.2
Tender_4899,3648540,571943,1445317,747071,310786,6723657,37.67,6.23
Tender_4900,1630774,2687978,575320,487550,127759,5509381,34.67,6.53
Tender_4901,8210499,4825387,2997776,417484,166843,16617989,39.0,6.1
Tender_4902,8577871,2571777,2835817,301437,133717,14420619,29.0,7.1
Tender_4903,8871904,4255519,753240,822899,162429,14865991,48.33,5.17
Tender_4904,2042157,2270514,1966953,337540,495143,7112307,40.67,5.93
Tender_4905,6714541,1185813,2998611,447926,137798,11484689,21.0,7.9
Tender_4906,3181182,1107387,1971167,135401,494727,6889864,51.67,4.83
Tender_4907,2075377,2418858,1147986,933812,350419,6926452,41.0,5.9
Tender_4908,4801447,1579604,2258565,704793,495051,9839460,32.0,6.8
Tender_4909,2886387,2922750,206751,922533,382913,7321334,41.0,5.9
Tender_4910,8171204,2302244,2082851,722089,53448,13331836,36.67,6.33
Tender_4911,7165110,4597617,1835380,230381,291733,14120221,37.33,6.27
Tender_4912,6291481,1623137,1709602,312558,226839,10163617,38.0,6.2
Tender_4913,7444240,3905534,1781633,935146,403281,14469834,38.67,6.13
Tender_4914,5880714,931956,245434,86281,434435,7578820,40.0,6.0
Tender_4915,7548078,4795932,2425093,52633,276674,15098410,36.67,6.33
Tender_4916,561289,4769002,1758098,145788,327414,7561591,42.67,5.73
Tender_4917,8215352,355349,1389222,809136,111327,10880386,33.0,6.7
Tender_4918,7315554,2568645,1334661,196466,341293,11756619,34.0,6.6
Tender_4919,2731152,2780028,1538788,101746,476336,7628050,47.67,5.23
Tender_4920,1333448,3943821,2685994,212077,344893,8520233,35.0,6.5
Tender_4921,4469659,3405526,2454163,656718,450921,11436987,32.33,6.77
Tender_4922,2224850,4995976,746173,577163,87600,8631762,44.0,5.6
Tender_4923,7056188,1603172,2720627,663927,348412,12392326,34.67,6.53
Tender_4924,3867090,1522021,2675312,716978,235847,9017248,25.33,7.47
Tender_4925,5452222,4839532,1384978,417540,218966,12313238,44.33,5.57
Tender_4926,1123073,3673677,1168233,425506,297141,6687630,61.67,3.83
Tender_4927,2534705,1411528,1241748,799105,283635,6270721,50.33,4.97
Tender_4928,1276538,3088761,2466612,373089,197915,7402915,47.0,5.3
Tender_4929,4961431,4811522,1466143,900504,189203,12328803,25.33,7.47
Tender_4930,3341650,2592309,340798,600716,281906,7157379,37.33,6.27
Tender_4931,1582766,4085518,1950000,953795,251921,8824000,38.67,6.13
Tender_4932,582881,255869,1857881,177461,415622,3289714,35.0,6.5
Tender_4933,6529227,4135627,1295700,885480,366666,13212700,49.33,5.07
Tender_4934,2217861,1409649,747881,532699,266625,5174715,35.0,6.5
Tender_4935,2247021,1070640,1297629,234183,102832,4952305,27.0,7.3
Tender_4936,4621157,4042199,2518452,474841,439486,12096135,49.67,5.03
Tender_4937,1362054,3685471,1058882,549860,376872,7033139,20.67,7.93
Tender_4938,982950,3150237,816318,772983,69928,5792416,36.67,6.33
Tender_4939,6738552,572830,2064637,287776,104121,9767916,52.0,4.8
Tender_4940,4949946,3050064,1055755,124018,268331,9448114,49.67,5.03
Tender_4941,5595774,1994789,2370355,748613,368872,11078403,28.33,7.17
Tender_4942,5860728,483587,1127657,200349,141164,7813485,43.33,5.67
Tender_4943,8645197,2299701,2278453,968267,89927,14281545,46.67,5.33
Tender_4944,3324827,2348128,2335977,650053,62831,8721816,46.0,5.4
Tender_4945,309669,1964399,2039562,266529,370458,4950617,50.0,5.0
Tender_4946,616286,825511,1808230,347667,388666,3986360,51.0,4.9
Tender_4947,9808250,4026681,361333,95044,331831,14623139,28.33,7.17
Tender_4948,4473430,2619241,77008,315555,176009,7661243,37.0,6.3
Tender_4949,1279131,571685,287261,527184,429467,3094728,36.33,6.37
Tender_4950,2332297,3397752,2808599,223039,81397,8843084,36.33,6.37
Tender_4951,4737323,2172713,1375257,147710,362971,8795974,33.0,6.7
Tender_4952,4453935,3123381,2662871,126080,125093,10491360,42.67,5.73
Tender_4953,6228756,521128,1099423,541848,201863,8593018,34.67,6.53
Tender_4954,2287615,4123295,2306407,314772,237046,9269135,52.0,4.8
Tender_4955,6496879,112491,645421,438962,74495,7768248,43.33,5.67
Tender_4956,1824447,451441,2036439,714331,52204,5078862,35.33,6.47
Tender_4957,5354983,3828216,224333,737127,211355,10356014,31.67,6.83
Tender_4958,7037579,2508420,1803755,495161,376216,12221131,26.67,7.33
Tender_4959,5780458,617726,2554059,892420,260858,10105521,33.67,6.63
Tender_4960,4351164,4021343,212387,113078,328955,9026927,32.33,6.77
Tender_4961,7996840,2150573,2370755,201942,304527,13024637,36.67,6.33
Tender_4962,240983,2109318,1974879,823920,387034,5536134,47.0,5.3
Tender_4963,2753491,4869390,2788243,484280,435858,11331262,22.33,7.77
Tender_4964,3853990,4190259,518783,883906,76998,9523936,38.33,6.17
Tender_4965,8782992,1924067,938866,545218,323733,12514876,41.67,5.83
Tender_4966,8101324,2839352,426254,937432,350797,12655159,45.33,5.47
Tender_4967,8894328,1062622,2627019,119963,170149,12874081,36.33,6.37
Tender_4968,4134240,306488,1985680,375439,278061,7079908,43.33,5.67
Tender_4969,3270920,4962630,704496,86754,411149,9435949,48.67,5.13
Tender_4970,3941605,161331,2189051,470495,102036,6864518,44.67,5.53
Tender_4971,3043939,4969258,1497415,206836,256403,9973851,55.67,4.43
Tender_4972,4290937,1779046,2199066,75646,472076,8816771,35.67,6.43
Tender_4973,6584599,1865031,278937,807202,449652,9985421,34.0,6.6
Tender_4974,7599472,850880,688034,941544,115697,10195627,27.67,7.23
Tender_4975,7572919,4468648,53705,698544,135316,12929132,34.33,6.57
Tender_4976,611562,3601129,2229296,453821,136285,7032093,48.67,5.13
Tender_4977,9448618,4407840,714765,708803,285335,15565361,28.67,7.13
Tender_4978,9734102,2115462,247994,262588,385392,12745538,38.0,6.2
Tender_4979,6417994,4984302,2954837,116290,78133,14551556,46.0,5.4
Tender_4980,3617442,4492136,2815811,513267,73779,11512435,32.0,6.8
Tender_4981,5202163,2808895,2851624,757487,437961,12058130,23.33,7.67
Tender_4982,2659107,4927104,1738529,971503,143130,10439373,41.0,5.9
Tender_4983,6140435,652932,1276065,631526,261731,8962689,31.33,6.87
Tender_4984,1313249,2241107,1673401,449267,98430,5775454,33.0,6.7
Tender_4985,8525698,3317781,147038,315809,276891,12583217,47.33,5.27
Tender_4986,1206784,2142176,594019,628876,279156,4851011,47.0,5.3
Tender_4987,2242937,3393333,2261381,680404,349422,8927477,53.0,4.7
Tender_4988,3423744,3257067,2224988,955167,234011,10094977,43.0,5.7
Tender_4989,5514971,3364012,2903755,522158,162633,12467529,51.67,4.83
Tender_4990,8598566,2041375,2691660,151361,449593,13932555,40.33,5.97
Tender_4991,9151123,4994576,873126,975736,205726,16200287,33.0,6.7
Tender_4992,1731026,662002,1765668,939101,165743,5263540,48.0,5.2
Tender_4993,2835195,4690110,2220617,874409,144600,10764931,21.33,7.87
Tender_4994,2225910,4920554,1562769,314668,376258,9400159,37.67,6.23
Tender_4995,6464584,518975,2082536,311950,228169,9606214,46.67,5.33
Tender_4996,6477105,453623,2290310,678856,82062,9981956,34.0,6.6
Tender_4997,6073883,4986709,1771968,506564,425981,13765105,32.0,6.8
Tender_4998,2460209,1086523,208638,482239,254145,4491754,39.67,6.03
Tender_4999,4630754,4300363,425029,856154,395084,10607384,39.67,6.03
Tender_5000,9581722,104926,1503206,998204,185978,12374036,34.0,6.6
Tender_5001,9867444,4100304,2243711,710000,255650,17177109,28.33,7.17
Tender_5002,4389435,2065396,83719,722581,62443,7323574,36.0,6.4
Tender_5003,224399,1444974,1123745,717992,65267,3576377,40.67,5.93
Tender_5004,8674404,894421,1074585,90799,475760,11209969,42.67,5.73
Tender_5005,8127753,4454365,2654516,827238,97681,16161553,22.0,7.8
Tender_5006,2267139,3079201,952568,866241,243800,7408949,52.0,4.8
Tender_5007,3623740,1139908,2608706,52501,471765,7896620,45.0,5.5
Tender_5008,420303,2381513,2285995,655053,235825,5978689,31.67,6.83
Tender_5009,1913375,637166,2358369,930813,111704,5951427,27.33,7.27
Tender_5010,6982183,4206241,2902510,588881,258856,14938671,35.67,6.43
Tender_5011,1738664,1818370,399629,459174,278559,4694396,35.0,6.5
Tender_5012,9523962,2429182,2786804,522852,53687,15316487,40.67,5.93
Tender_5013,8970818,4509045,2192804,612707,298615,16583989,28.33,7.17
Tender_5014,648134,3392475,1854252,50270,143784,6088915,46.67,5.33
Tender_5015,5379378,369674,2476102,756010,332389,9313553,44.33,5.57
Tender_5016,1353909,3890553,1801460,70821,347806,7464549,49.0,5.1
Tender_5017,1938018,839392,2020233,80772,395985,5274400,34.67,6.53
Tender_5018,3242598,3914343,1450630,119470,331329,9058370,42.0,5.8
Tender_5019,1298850,4183550,72447,870923,388796,6814566,36.33,6.37
Tender_5020,2389557,2723917,1299562,304343,253199,6970578,49.0,5.1
Tender_5021,6659441,2535041,1307173,261194,220588,10983437,42.33,5.77
Tender_5022,2256884,3169961,1817752,91195,319287,7655079,51.33,4.87
Tender_5023,1037597,253331,1181824,250571,480206,3203529,17.0,8.3
Tender_5024,275943,4164719,2703287,354135,169788,7667872,40.0,6.0
Tender_5025,7332243,3146696,2934516,862920,74789,14351164,49.67,5.03
Tender_5026,2186193,3417881,928191,693729,359008,7585002,39.0,6.1
Tender_5027,1014144,4321350,265084,64834,319879,5985291,51.33,4.87
Tender_5028,2495791,3683971,2120613,236798,167452,8704625,51.0,4.9
Tender_5029,9788551,4702164,2135402,424887,278617,17329621,34.33,6.57
Tender_5030,6741109,322602,813502,554023,270370,8701606,50.33,4.97
Tender_5031,8112527,2572840,246691,402550,393051,11727659,41.67,5.83
Tender_5032,4687448,4210657,2008482,141786,209383,11257756,46.33,5.37
Tender_5033,7219616,4263117,2827996,112176,436945,14859850,30.33,6.97
Tender_5034,8079438,4903108,2199337,795647,98730,16076260,36.67,6.33
Tender_5035,7563924,547389,249267,636443,492867,9489890,27.67,7.23
Tender_5036,8777341,583463,835828,729192,267634,11193458,35.0,6.5
Tender_5037,623413,826733,2336340,804752,246280,4837518,41.33,5.87
Tender_5038,3450700,1694141,708911,133996,58529,6046277,35.67,6.43
Tender_5039,4967757,4798069,2971079,663483,473005,13873393,39.0,6.1
Tender_5040,9786146,4571881,1976610,900984,298013,17533634,21.67,7.83
Tender_5041,3461199,3144099,992364,736455,426566,8760683,36.0,6.4
Tender_5042,1957999,4934926,2426275,271315,254351,9844866,25.67,7.43
Tender_5043,7510867,3829244,2283681,975594,241684,14841070,27.33,7.27
Tender_5044,4106684,4638041,242395,687455,255508,9930083,41.0,5.9
Tender_5045,3809423,3965550,2476420,103992,302061,10657446,31.0,6.9
Tender_5046,5299135,700468,2617300,179081,175220,8971204,37.67,6.23
Tender_5047,9323454,4953093,2294373,752919,331833,17655672,44.33,5.57
Tender_5048,4149316,858519,2194044,412205,456811,8070895,48.0,5.2
Tender_5049,6347806,2196779,2859182,371316,234038,12009121,33.67,6.63
Tender_5050,6294735,1670336,2474105,853164,290185,11582525,21.67,7.83
Tender_5051,7610440,638998,1444683,74241,243019,10011381,32.0,6.8
Tender_5052,5434408,1086548,995949,382333,84210,7983448,32.67,6.73
Tender_5053,9867080,4192194,2060800,895961,284128,17300163,47.67,5.23
Tender_5054,695334,561684,1970968,467591,96847,3792424,43.67,5.63
Tender_5055,9290332,2829935,1347334,227976,199110,13894687,56.67,4.33
Tender_5056,5931484,4973115,1923275,479026,237724,13544624,50.33,4.97
Tender_5057,7579087,2562932,1686276,641900,139487,12609682,47.33,5.27
Tender_5058,5229053,3365126,2667524,746235,137948,12145886,41.33,5.87
Tender_5059,8380690,3257480,918909,393460,212491,13163030,32.67,6.73
Tender_5060,1598845,3371139,156900,669452,86629,5882965,36.0,6.4
Tender_5061,8438197,994196,1259393,441854,477713,11611353,24.33,7.57
Tender_5062,7624122,2268675,1473780,156368,190822,11713767,32.0,6.8
Tender_5063,1998698,4077558,351488,647035,441909,7516688,40.33,5.97
Tender_5064,5564830,4957294,204443,562623,399632,11688822,30.0,7.0
Tender_5065,5809600,3925691,1570302,393544,359135,12058272,58.67,4.13
Tender_5066,7077799,4845694,2298056,265138,110701,14597388,38.0,6.2
Tender_5067,5095489,1767209,959640,682435,388080,8892853,39.0,6.1
Tender_5068,8952109,4377556,2091856,617758,428263,16467542,29.33,7.07
Tender_5069,9851105,4972453,2358639,644040,79228,17905465,32.0,6.8
Tender_5070,6513365,1263252,1352035,415838,349287,9893777,44.33,5.57
Tender_5071,4439882,3382982,2568867,358063,461785,11211579,39.33,6.07
Tender_5072,4154168,2337073,2200857,521830,61282,9275210,31.33,6.87
Tender_5073,2759959,4501621,1850018,488591,379648,9979837,36.33,6.37
Tender_5074,2734399,874998,220840,679755,219589,4729581,24.33,7.57
Tender_5075,4592166,1995940,305073,721844,161386,7776409,37.0,6.3
Tender_5076,6778907,2174924,1622823,59558,350571,10986783,33.0,6.7
Tender_5077,6682587,3236485,1305403,655573,484268,12364316,44.0,5.6
Tender_5078,4104357,1180302,635561,330410,61772,6312402,38.0,6.2
Tender_5079,1992309,3079614,1559040,147112,198657,6976732,46.67,5.33
Tender_5080,9161692,2437816,348965,403402,72092,12423967,28.0,7.2
Tender_5081,1889204,583439,2275159,594418,79615,5421835,41.0,5.9
Tender_5082,5657450,346108,2201429,452741,190725,8848453,41.67,5.83
Tender_5083,9141651,3032342,1875562,284149,432968,14766672,36.0,6.4
Tender_5084,7254188,2536385,2770755,159773,202150,12923251,36.67,6.33
Tender_5085,232723,2869019,2225715,655290,186546,6169293,50.67,4.93
Tender_5086,3502377,2046785,2615377,436170,105287,8705996,40.0,6.0
Tender_5087,2876249,332467,262268,926277,340610,4737871,35.0,6.5
Tender_5088,6708664,2693568,2913097,649283,109549,13074161,34.0,6.6
Tender_5089,3592436,1224902,1518360,101650,461024,6898372,28.33,7.17
Tender_5090,4419902,1013260,1520553,307357,292147,7553219,35.0,6.5
Tender_5091,3493123,2492305,123720,407948,271767,6788863,48.67,5.13
Tender_5092,1072836,2120781,2112244,570974,345903,6222738,39.33,6.07
Tender_5093,2711870,816607,2024392,858185,170696,6581750,48.67,5.13
Tender_5094,7425574,3610600,2188670,771877,230065,14226786,39.0,6.1
Tender_5095,2841979,3537195,2313681,660762,80204,9433821,34.0,6.6
Tender_5096,526939,3028262,1150467,112147,340618,5158433,41.67,5.83
Tender_5097,4944593,1059774,1002959,476439,453204,7936969,32.0,6.8
Tender_5098,8796753,4783678,2483852,239292,164494,16468069,35.67,6.43
Tender_5099,2465137,2234384,2450162,745043,419409,8314135,26.33,7.37
Tender_5100,4421897,305099,1600592,215674,296656,6839918,17.67,8.23
Tender_5101,535037,1762743,2797601,330154,382707,5808242,47.67,5.23
Tender_5102,2069436,3435245,2819345,623722,66565,9014313,19.33,8.07
Tender_5103,6027112,2290879,141338,847412,75578,9382319,49.67,5.03
Tender_5104,2637737,477579,2592794,131688,461656,6301454,35.67,6.43
Tender_5105,1379156,1269951,475889,299843,254877,3679716,37.67,6.23
Tender_5106,7758016,4953336,2284356,945129,214425,16155262,48.33,5.17
Tender_5107,3678886,4638211,384309,653644,318842,9673892,23.0,7.7
Tender_5108,9254230,856301,1263726,971211,272035,12617503,39.67,6.03
Tender_5109,2050701,3733913,2620595,979055,411717,9795981,40.67,5.93
Tender_5110,1051047,4345503,2265992,770515,316424,8749481,52.33,4.77
Tender_5111,1331602,4188946,2814221,189655,406366,8930790,43.67,5.63
Tender_5112,8954420,4784686,947860,664400,387923,15739289,21.33,7.87
Tender_5113,7660662,1926861,1432136,840222,485179,12345060,51.0,4.9
Tender_5114,4200277,1880200,236494,749647,357425,7424043,40.0,6.0
Tender_5115,3651124,1665231,759884,322466,144701,6543406,34.0,6.6
Tender_5116,3266271,3285035,1829724,984734,160548,9526312,45.0,5.5
Tender_5117,4976805,1425261,1532455,244979,434794,8614294,32.33,6.77
Tender_5118,8206787,1126891,697699,866851,481408,11379636,39.0,6.1
Tender_5119,1852614,252441,2272334,827276,496788,5701453,34.67,6.53
Tender_5120,5942517,294347,2057926,593876,462011,9350677,26.33,7.37
Tender_5121,2924863,1988743,2450186,554165,168053,8086010,23.0,7.7
Tender_5122,5931197,4628074,197950,183849,496502,11437572,44.33,5.57
Tender_5123,9545988,2926036,1395662,978380,304841,15150907,52.0,4.8
Tender_5124,6886365,4363472,2621003,565375,366409,14802624,43.67,5.63
Tender_5125,8178927,2334590,1930832,487913,124385,13056647,46.0,5.4
Tender_5126,4125352,4090530,981474,387093,58935,9643384,27.67,7.23
Tender_5127,1213206,1186578,70090,122685,262552,2855111,43.33,5.67
Tender_5128,3386439,4845028,2856331,781324,155066,12024188,57.67,4.23
Tender_5129,1930528,1105357,2973619,174324,331987,6515815,40.0,6.0
Tender_5130,6704691,2883744,1927543,824962,63635,12404575,38.0,6.2
Tender_5131,9745615,3211642,1903583,364991,299999,15525830,37.33,6.27
Tender_5132,7675469,943563,2095520,86462,474710,11275724,29.33,7.07
Tender_5133,3157756,2793746,2396917,218573,256460,8823452,31.0,6.9
Tender_5134,8926921,1553475,511117,930931,356716,12279160,24.33,7.57
Tender_5135,1914779,980978,252644,94139,264545,3507085,29.67,7.03
Tender_5136,9250651,4538876,2281810,887115,377377,17335829,36.0,6.4
Tender_5137,8757535,1737145,2358541,68930,310808,13232959,19.67,8.03
Tender_5138,6402411,3523523,497421,820200,131594,11375149,44.67,5.53
Tender_5139,9161517,1288279,1076883,572384,363341,12462404,44.0,5.6
Tender_5140,4400712,1893752,218856,737851,66541,7317712,27.0,7.3
Tender_5141,824975,333344,1607940,843985,79718,3689962,48.67,5.13
Tender_5142,7867844,4594193,1890140,777855,246641,15376673,48.67,5.13
Tender_5143,4256729,774845,1478214,247310,191728,6948826,43.0,5.7
Tender_5144,5050623,3977478,1181977,173124,175522,10558724,47.67,5.23
Tender_5145,4039764,1285742,471664,711821,403586,6912577,44.0,5.6
Tender_5146,1591323,3439753,133407,75080,384966,5624529,20.67,7.93
Tender_5147,9790777,246630,89028,451403,456719,11034557,46.0,5.4
Tender_5148,542614,4137105,895685,751061,343506,6669971,35.0,6.5
Tender_5149,9410218,3707432,460683,432213,481912,14492458,46.0,5.4
Tender_5150,6149694,844331,1781655,222075,399075,9396830,33.33,6.67
Tender_5151,7716112,1152066,2504167,446093,212823,12031261,39.0,6.1
Tender_5152,3759824,2417036,2590073,553994,131341,9452268,35.33,6.47
Tender_5153,4833030,1180082,1685226,562652,322307,8583297,32.67,6.73
Tender_5154,6818397,521496,705091,473748,128440,8647172,41.67,5.83
Tender_5155,8851607,2689854,372710,531161,180480,12625812,31.67,6.83
Tender_5156,7504064,2265734,907831,498784,360997,11537410,38.33,6.17
Tender_5157,7938976,736950,2455097,301281,470131,11902435,39.33,6.07
Tender_5158,5899359,2891230,788105,652206,273419,10504319,31.67,6.83
Tender_5159,9426601,3405873,875456,999531,171716,14879177,36.0,6.4
Tender_5160,8148248,4650263,2279133,880532,357295,16315471,21.0,7.9
Tender_5161,1219538,1243530,552952,171145,115316,3302481,36.0,6.4
Tender_5162,1761722,602310,1736390,535857,261742,4898021,31.67,6.83
Tender_5163,5731936,4056112,1566842,853756,426486,12635132,51.0,4.9
Tender_5164,5011784,1395647,404697,125886,174898,7112912,45.67,5.43
Tender_5165,2748056,4159630,1136947,79917,452121,8576671,48.67,5.13
Tender_5166,2434942,4872514,604104,353326,333602,8598488,37.0,6.3
Tender_5167,8473027,4872802,2697915,761626,316695,17122065,30.67,6.93
Tender_5168,863810,2564695,1103190,308508,496697,5336900,34.33,6.57
Tender_5169,6369934,4894543,939945,315157,442606,12962185,55.33,4.47
Tender_5170,6479129,2433094,668201,796420,314461,10691305,32.33,6.77
Tender_5171,8179590,566046,2588313,947339,384920,12666208,35.67,6.43
Tender_5172,7837863,1109834,1203731,118288,319563,10589279,35.33,6.47
Tender_5173,2828387,4429046,718757,85258,281923,8343371,42.0,5.8
Tender_5174,783643,4473943,2722950,793673,59992,8834201,39.0,6.1
Tender_5175,987148,4944778,2649531,467625,216915,9265997,44.33,5.57
Tender_5176,5587886,1561382,690654,187637,119404,8146963,40.33,5.97
Tender_5177,4131437,3329881,2245284,579583,300634,10586819,27.33,7.27
Tender_5178,7162762,3657729,2947377,467982,258767,14494617,37.0,6.3
Tender_5179,9408332,1623619,1336532,780894,313569,13462946,45.0,5.5
Tender_5180,9004372,4932880,88721,313659,154410,14494042,50.0,5.0
Tender_5181,1075649,2015557,1835258,573108,287227,5786799,52.0,4.8
Tender_5182,9495009,3298006,1279066,709331,378478,15159890,27.33,7.27
Tender_5183,9867995,3873525,1437224,683656,178651,16041051,39.67,6.03
Tender_5184,7450077,2213033,913848,237226,223546,11037730,44.67,5.53
Tender_5185,4786805,571333,1030560,260214,188794,6837706,58.33,4.17
Tender_5186,3902667,4351529,2339243,139862,483147,11216448,19.33,8.07
Tender_5187,5459233,3583815,1332173,551779,321217,11248217,33.0,6.7
Tender_5188,4328067,3185074,1560454,796048,478134,10347777,50.0,5.0
Tender_5189,9339636,3537292,730094,832478,389781,14829281,48.0,5.2
Tender_5190,3156796,425015,1303409,797229,472215,6154664,50.0,5.0
Tender_5191,733547,361202,1934304,453358,254136,3736547,33.67,6.63
Tender_5192,1916960,1483212,2597590,134988,261407,6394157,35.67,6.43
Tender_5193,9250096,1600613,2615074,830664,496314,14792761,34.0,6.6
Tender_5194,8067577,4987348,2734092,974959,349520,17113496,41.0,5.9
Tender_5195,8405192,2968635,1148533,760890,99599,13382849,46.33,5.37
Tender_5196,7130285,4216935,498299,153267,198640,12197426,42.0,5.8
Tender_5197,7780402,308715,2579622,327797,460214,11456750,49.67,5.03
Tender_5198,1527639,1972441,1997091,511920,119876,6128967,29.67,7.03
Tender_5199,2946622,2604160,898125,816764,214399,7480070,39.33,6.07
Tender_5200,9789813,1709011,1448539,932445,466714,14346522,28.67,7.13
Tender_5201,4710722,3007789,1919925,714895,222530,10575861,42.67,5.73
Tender_5202,4432624,3245649,502073,593523,211604,8985473,46.67,5.33
Tender_5203,1492516,1879116,2300441,589560,124738,6386371,34.33,6.57
Tender_5204,1363536,2365290,2330230,185193,220105,6464354,33.67,6.63
Tender_5205,6411574,1085773,805939,369946,393788,9067020,31.33,6.87
Tender_5206,3902995,4084537,2226013,966485,463118,11643148,33.0,6.7
Tender_5207,235000,3361743,1605746,319810,218230,5740529,37.67,6.23
Tender_5208,2006675,596480,912305,617328,231173,4363961,36.33,6.37
Tender_5209,2711816,4129811,1033326,155712,404894,8435559,39.33,6.07
Tender_5210,8482355,4477731,632443,926408,363977,14882914,52.0,4.8
Tender_5211,1145973,4223722,897716,392733,357037,7017181,47.0,5.3
Tender_5212,7659221,3399606,479906,887867,130673,12557273,33.67,6.63
Tender_5213,3444051,4089302,2609285,504827,465221,11112686,53.0,4.7
Tender_5214,6671109,2138082,1508714,342216,412266,11072387,41.33,5.87
Tender_5215,6912925,3614060,565293,188706,485242,11766226,26.67,7.33
Tender_5216,3196802,4732794,712108,468296,322914,9432914,41.67,5.83
Tender_5217,1066676,1139352,462466,359814,470869,3499177,43.67,5.63
Tender_5218,7069010,3104821,2965437,934223,229385,14302876,34.33,6.57
Tender_5219,2739194,1669855,1432675,257825,403861,6503410,57.0,4.3
Tender_5220,8532765,471304,1180471,696464,174246,11055250,43.33,5.67
Tender_5221,2297207,4541701,2715185,751940,154721,10460754,39.33,6.07
Tender_5222,4537261,2685497,2277606,497335,496380,10494079,40.67,5.93
Tender_5223,4872999,3255991,1897440,692543,403964,11122937,41.0,5.9
Tender_5224,7821036,2152716,2320940,334509,342571,12971772,44.0,5.6
Tender_5225,397111,2486374,2804905,421094,310140,6419624,32.67,6.73
Tender_5226,9707934,4227152,2595887,678545,260313,17469831,49.33,5.07
Tender_5227,9955666,3831598,2089494,163902,219147,16259807,47.33,5.27
Tender_5228,7396256,4023571,226820,414703,382888,12444238,36.33,6.37
Tender_5229,8095019,2260011,2250008,168964,301178,13075180,43.0,5.7
Tender_5230,4561618,980057,1915024,751427,245741,8453867,30.33,6.97
Tender_5231,6318113,3009472,1356498,127197,341350,11152630,53.33,4.67
Tender_5232,426813,2613169,1666336,448873,124678,5279869,34.0,6.6
Tender_5233,7808620,3700508,2096745,140304,185167,13931344,45.0,5.5
Tender_5234,1286857,1744568,1154233,306894,64898,4557450,39.67,6.03
Tender_5235,7443641,1927873,298687,156633,340470,10167304,19.0,8.1
Tender_5236,2635087,2637584,2650073,933203,169421,9025368,43.0,5.7
Tender_5237,4107074,2595358,89368,355103,188254,7335157,31.67,6.83
Tender_5238,2803000,1131578,2890158,803365,100915,7729016,36.33,6.37
Tender_5239,6183131,403289,1643602,589633,236313,9055968,42.67,5.73
Tender_5240,2432819,836858,506101,860184,318279,4954241,23.0,7.7
Tender_5241,7498095,1584393,1175954,700213,413158,11371813,40.67,5.93
Tender_5242,6026342,4743471,957890,511238,229577,12468518,32.67,6.73
Tender_5243,6315519,336973,1378764,778386,344833,9154475,42.0,5.8
Tender_5244,5778822,1595323,1642511,127031,160019,9303706,32.33,6.77
Tender_5245,7650994,4962025,2885474,829396,356958,16684847,20.67,7.93
Tender_5246,5884892,656342,2699143,649446,150001,10039824,55.67,4.43
Tender_5247,7649428,2647260,1088631,395766,254777,12035862,24.0,7.6
Tender_5248,7041065,1785948,318677,399861,260610,9806161,37.0,6.3
Tender_5249,8821816,4925812,154829,167140,75922,14145519,32.0,6.8
Tender_5250,2257780,2268347,2303899,327332,223831,7381189,25.0,7.5
Tender_5251,2060368,1321101,692477,449971,243508,4767425,48.33,5.17
Tender_5252,2929528,553216,1038687,238584,398153,5158168,41.0,5.9
Tender_5253,330075,3822456,815499,308858,382040,5658928,31.33,6.87
Tender_5254,808338,2269415,2731942,69333,150662,6029690,35.0,6.5
Tender_5255,6201588,4302697,347197,817215,281209,11949906,38.67,6.13
Tender_5256,7236005,575821,508998,943181,431193,9695198,36.67,6.33
Tender_5257,5579424,672709,560458,171073,318415,7302079,39.67,6.03
Tender_5258,5510498,2915031,1450810,861630,133878,10871847,40.33,5.97
Tender_5259,6003886,3117443,114383,813461,474423,10523596,33.0,6.7
Tender_5260,4290716,3941984,2226534,895475,350795,11705504,49.33,5.07
Tender_5261,1016009,1491893,833101,710033,103295,4154331,40.33,5.97
Tender_5262,4428491,575180,1288040,278327,221386,6791424,58.0,4.2
Tender_5263,542385,3011877,2905206,566941,348743,7375152,34.33,6.57
Tender_5264,8289499,3328566,2765617,891165,237092,15511939,25.67,7.43
Tender_5265,4866530,2737607,2191527,168954,58650,10023268,42.67,5.73
Tender_5266,3542184,1245710,1809963,928253,499892,8026002,35.0,6.5
Tender_5267,3621900,1533794,2759734,631407,293964,8840799,52.67,4.73
Tender_5268,9105465,3918050,426781,946620,439398,14836314,36.0,6.4
Tender_5269,7894706,759739,2715745,673827,102793,12146810,59.0,4.1
Tender_5270,2848583,1259448,462743,891699,272818,5735291,49.0,5.1
Tender_5271,7739399,3618399,1295563,251000,115736,13020097,44.33,5.57
Tender_5272,361845,4704244,379009,205241,288923,5939262,45.67,5.43
Tender_5273,8176045,254820,1767920,943324,314097,11456206,37.33,6.27
Tender_5274,6264205,3992750,962642,539867,458695,12218159,35.33,6.47
Tender_5275,3800505,3220952,1555811,466453,489685,9533406,42.67,5.73
Tender_5276,4012285,398323,1455294,496054,245119,6607075,28.67,7.13
Tender_5277,6105347,551049,1494626,437632,201729,8790383,38.33,6.17
Tender_5278,3154586,4887102,2080810,189680,305237,10617415,41.0,5.9
Tender_5279,4998530,3346120,2162981,804008,191517,11503156,33.33,6.67
Tender_5280,3005539,3937121,2250277,481562,127500,9801999,39.0,6.1
Tender_5281,3471010,135623,1189187,577792,349643,5723255,34.0,6.6
Tender_5282,9571180,4402566,414781,426843,72314,14887684,38.0,6.2
Tender_5283,5227652,2079803,1232974,309727,244958,9095114,36.67,6.33
Tender_5284,4405065,1829797,1506100,64387,299958,8105307,47.0,5.3
Tender_5285,9497113,4467860,1966893,516605,488942,16937413,51.33,4.87
Tender_5286,2372621,4525314,1251029,845053,325047,9319064,30.33,6.97
Tender_5287,4342398,4523607,2059523,359978,354563,11640069,40.0,6.0
Tender_5288,2723247,177440,1064668,810524,237268,5013147,50.0,5.0
Tender_5289,9339597,3696945,1492706,822851,390661,15742760,42.0,5.8
Tender_5290,411146,4822165,1494862,373149,320684,7422006,40.67,5.93
Tender_5291,1827036,3956876,2401487,98247,390559,8674205,32.33,6.77
Tender_5292,8110213,2075628,1966840,149990,433155,12735826,27.0,7.3
Tender_5293,1248717,1763036,2268344,774919,478739,6533755,22.33,7.77
Tender_5294,815493,4541906,2753333,336895,188533,8636160,28.0,7.2
Tender_5295,6852668,1178978,2741194,794030,130857,11697727,55.67,4.43
Tender_5296,3577548,4352685,1389572,249362,447533,10016700,25.33,7.47
Tender_5297,8366935,4151828,2141493,470669,373617,15504542,33.33,6.67
Tender_5298,9009643,4365268,1668326,493483,494760,16031480,34.0,6.6
Tender_5299,1469515,769742,2060216,747912,222862,5270247,36.0,6.4
Tender_5300,2250044,3810516,377214,316128,143605,6897507,35.0,6.5
Tender_5301,9352034,1365691,1670644,899639,198875,13486883,56.67,4.33
Tender_5302,7433905,1754289,995539,317697,372175,10873605,45.33,5.47
Tender_5303,8960372,2936466,1322291,816228,266553,14301910,30.0,7.0
Tender_5304,4272469,1626498,1169213,500247,474016,8042443,24.33,7.57
Tender_5305,9319467,4785360,2145242,647319,289895,17187283,39.67,6.03
Tender_5306,3739164,4613225,1976394,62683,134642,10526108,38.33,6.17
Tender_5307,5963874,989144,2410818,219767,247076,9830679,44.67,5.53
Tender_5308,4569823,3084150,2372542,337398,357180,10721093,37.33,6.27
Tender_5309,3403556,903442,1925282,710965,250940,7194185,42.67,5.73
Tender_5310,4848504,1696874,1035653,499532,96749,8177312,42.33,5.77
Tender_5311,5790165,3731541,887371,469676,364065,11242818,28.33,7.17
Tender_5312,8574728,1521925,395909,489621,380640,11362823,40.0,6.0
Tender_5313,1505215,4343392,396450,838481,102782,7186320,39.0,6.1
Tender_5314,2442125,4284240,2457592,821002,484261,10489220,39.33,6.07
Tender_5315,9573146,922503,1895942,342636,142357,12876584,50.33,4.97
Tender_5316,4978616,308377,1498008,707792,151514,7644307,38.0,6.2
Tender_5317,1129622,297198,1931565,422457,470904,4251746,30.0,7.0
Tender_5318,3859760,1605626,1596716,98762,452619,7613483,49.0,5.1
Tender_5319,8710415,1862918,1095461,182084,335708,12186586,39.67,6.03
Tender_5320,4610146,4950219,311441,652485,57066,10581357,47.0,5.3
Tender_5321,1241867,4052330,2774844,640424,224584,8934049,36.0,6.4
Tender_5322,6375825,3893817,1280162,530304,73965,12154073,42.67,5.73
Tender_5323,9472307,234340,1414959,129293,321327,11572226,40.33,5.97
Tender_5324,9089005,2356881,889359,823905,457445,13616595,48.67,5.13
Tender_5325,7983267,1954383,2007317,580888,403307,12929162,38.0,6.2
Tender_5326,309326,661252,269753,651237,419358,2310926,37.67,6.23
Tender_5327,4422177,1842151,2139174,288197,180730,8872429,42.0,5.8
Tender_5328,1753937,2547536,1185206,311762,166884,5965325,45.67,5.43
Tender_5329,9719327,3077526,2865940,180940,214831,16058564,39.67,6.03
Tender_5330,3530509,3212042,2136784,680304,58897,9618536,42.33,5.77
Tender_5331,2111580,630110,461680,322932,213711,3740013,36.67,6.33
Tender_5332,9377082,3519079,941308,510572,137210,14485251,23.33,7.67
Tender_5333,7940365,1827284,368274,966657,232717,11335297,41.0,5.9
Tender_5334,3877004,4545740,1113565,735021,324543,10595873,35.67,6.43
Tender_5335,2378137,4402277,961291,858583,450972,9051260,24.67,7.53
Tender_5336,4111514,4333959,2476965,181784,408490,11512712,39.33,6.07
Tender_5337,3423143,2132441,1776673,302418,463171,8097846,50.0,5.0
Tender_5338,5680472,1596393,2432081,905258,237173,10851377,37.33,6.27
Tender_5339,1908978,4327784,682863,398630,415753,7734008,43.33,5.67
Tender_5340,9712454,3809654,1770929,223021,445322,15961380,54.67,4.53
Tender_5341,5713297,1063586,405159,815303,158913,8156258,41.0,5.9
Tender_5342,1070092,440051,2430039,319344,379765,4639291,28.0,7.2
Tender_5343,7150788,3206653,2822128,600452,396675,14176696,29.67,7.03
Tender_5344,2555821,3988370,585825,604269,339888,8074173,48.0,5.2
Tender_5345,3370968,2798213,2257723,801524,432291,9660719,45.33,5.47
Tender_5346,4333957,2326487,760238,98840,257763,7777285,35.0,6.5
Tender_5347,5311983,4677616,2901132,550995,314384,13756110,52.0,4.8
Tender_5348,4786119,751383,2820840,724967,150774,9234083,23.33,7.67
Tender_5349,633927,1070354,2003031,150225,228182,4085719,30.0,7.0
Tender_5350,6304862,734074,2709487,691627,113559,10553609,35.33,6.47
Tender_5351,9704721,4584680,2580359,759563,85800,17715123,33.33,6.67
Tender_5352,4299102,216259,1023038,753132,374313,6665844,49.0,5.1
Tender_5353,9477127,4785947,208047,921006,80346,15472473,37.33,6.27
Tender_5354,9327004,856744,1903469,471939,432880,12992036,37.33,6.27
Tender_5355,4134245,3535033,2848373,288442,156541,10962634,39.67,6.03
Tender_5356,4277853,3761571,1605376,147314,493612,10285726,29.67,7.03
Tender_5357,3497958,176569,239751,368518,393829,4676625,41.33,5.87
Tender_5358,3723878,4677182,1146187,200250,235514,9983011,25.0,7.5
Tender_5359,7678529,4878517,1900993,645527,473578,15577144,24.67,7.53
Tender_5360,8945124,4718576,1448974,116231,496060,15724965,45.33,5.47
Tender_5361,8364719,1008492,2005888,605743,345529,12330371,39.0,6.1
Tender_5362,3630605,1086789,300576,400261,152585,5570816,28.33,7.17
Tender_5363,4054715,1402933,2421097,128609,283955,8291309,31.0,6.9
Tender_5364,5677246,4365857,2730745,458440,469785,13702073,34.33,6.57
Tender_5365,8997239,1034273,1889406,586743,483901,12991562,48.0,5.2
Tender_5366,1189800,2612987,1328943,453745,418769,6004244,44.0,5.6
Tender_5367,5674374,4155053,2918653,212408,239938,13200426,42.33,5.77
Tender_5368,9418419,926587,565449,167081,260483,11338019,48.67,5.13
Tender_5369,2911161,2332781,1151802,926237,174282,7496263,54.33,4.57
Tender_5370,9107653,2093532,571436,923557,318978,13015156,48.0,5.2
Tender_5371,5896580,4728541,2126948,206696,340093,13298858,45.33,5.47
Tender_5372,9737665,2585868,1341668,366650,232166,14264017,44.33,5.57
Tender_5373,8651997,370804,1410898,289749,254050,10977498,26.0,7.4
Tender_5374,1337800,1000289,179681,646625,332950,3497345,35.67,6.43
Tender_5375,4950154,856772,459376,105368,233721,6605391,27.33,7.27
Tender_5376,8881682,2943929,2874829,715093,175990,15591523,44.33,5.57
Tender_5377,9196821,2477899,2761327,597381,406120,15439548,57.67,4.23
Tender_5378,402294,344428,2820123,171580,96006,3834431,39.67,6.03
Tender_5379,5626892,1792952,2920533,420694,476999,11238070,33.67,6.63
Tender_5380,5808364,1751341,462878,685822,438504,9146909,48.0,5.2
Tender_5381,1322205,2953693,2932133,753478,366566,8328075,57.0,4.3
Tender_5382,6071893,3663210,1447058,540286,411733,12134180,29.33,7.07
Tender_5383,5941274,4994775,2566628,727581,174318,14404576,49.33,5.07
Tender_5384,7087636,559900,1547109,246650,472596,9913891,32.67,6.73
Tender_5385,8389829,608812,2619628,208606,231929,12058804,31.33,6.87
Tender_5386,4799997,3953511,1088993,331216,235962,10409679,38.67,6.13
Tender_5387,6967389,428788,351479,636048,391503,8775207,45.0,5.5
Tender_5388,5250128,2854263,2354596,748400,273242,11480629,36.0,6.4
Tender_5389,2437217,2733243,1608418,778741,393408,7951027,45.0,5.5
Tender_5390,3269168,1807920,2075048,721994,208236,8082366,33.0,6.7
Tender_5391,7961190,240708,2959426,246986,437563,11845873,38.67,6.13
Tender_5392,3537142,3694048,355924,768832,475493,8831439,41.67,5.83
Tender_5393,1077693,1227113,2548599,167377,138776,5159558,30.67,6.93
Tender_5394,824075,4224245,1910903,689167,375003,8023393,25.33,7.47
Tender_5395,7163855,3847957,1391080,137873,120623,12661388,18.0,8.2
Tender_5396,4220880,794284,413361,386724,297872,6113121,35.33,6.47
Tender_5397,6767925,4736638,1733954,670462,460877,14369856,35.67,6.43
Tender_5398,5116335,3618117,1168767,958033,394807,11256059,33.33,6.67
Tender_5399,7971363,4437495,1108273,910308,287815,14715254,52.0,4.8
Tender_5400,840143,3542026,1925209,321477,329946,6958801,22.67,7.73
Tender_5401,4862099,4594703,2278851,245137,143817,12124607,33.0,6.7
Tender_5402,8990306,1770408,1418653,650379,154078,12983824,41.33,5.87
Tender_5403,8233962,599176,2344815,461496,260380,11899829,41.0,5.9
Tender_5404,1204893,1033023,2450528,622588,340800,5651832,31.0,6.9
Tender_5405,5127947,3828636,1322120,674132,86611,11039446,46.0,5.4
Tender_5406,2557717,4248115,1115791,347505,175331,8444459,51.67,4.83
Tender_5407,9099185,3641896,873679,424650,471428,14510838,22.67,7.73
Tender_5408,952504,1581200,2618867,569406,91374,5813351,45.67,5.43
Tender_5409,4748395,3502955,1988444,183666,192336,10615796,41.67,5.83
Tender_5410,9274359,547374,1638907,666113,177327,12304080,23.33,7.67
Tender_5411,2024608,2228302,706086,701113,213447,5873556,34.33,6.57
Tender_5412,2563965,1322415,399883,587272,118785,4992320,48.33,5.17
Tender_5413,5090949,4125080,140639,849485,51440,10257593,39.33,6.07
Tender_5414,4731669,2678049,2207239,513900,181140,10311997,33.0,6.7
Tender_5415,7630904,3209425,2426660,226891,139143,13633023,37.0,6.3
Tender_5416,7280010,2162389,2973210,832440,468401,13716450,27.33,7.27
Tender_5417,3798382,4041549,2097424,854001,213413,11004769,35.33,6.47
Tender_5418,3481731,3215548,1147607,474699,373286,8692871,57.33,4.27
Tender_5419,7839062,3467479,2370322,67462,447012,14191337,33.67,6.63
Tender_5420,8397341,3595544,1539307,562593,498268,14593053,29.33,7.07
Tender_5421,9801221,4713529,1350517,163466,167987,16196720,42.33,5.77
Tender_5422,4218825,1487344,751474,593003,433582,7484228,59.67,4.03
Tender_5423,8761592,3422998,235521,566540,368823,13355474,44.0,5.6
Tender_5424,517723,588967,2148255,908831,288175,4451951,44.67,5.53
Tender_5425,4464319,3478122,1299810,834508,463986,10540745,38.67,6.13
Tender_5426,7722917,1311534,2401792,71967,275295,11783505,44.33,5.57
Tender_5427,883488,4803087,2916697,896991,326364,9826627,45.67,5.43
Tender_5428,2103724,258946,549712,675100,186578,3774060,47.33,5.27
Tender_5429,4289243,2674516,1031769,894819,401387,9291734,30.0,7.0
Tender_5430,348159,1094877,2450453,514079,396115,4803683,28.67,7.13
Tender_5431,3542278,3872206,2988685,949464,480502,11833135,45.67,5.43
Tender_5432,7811643,3233119,2793471,410359,320573,14569165,25.0,7.5
Tender_5433,7411617,4763124,1450402,191933,181618,13998694,33.67,6.63
Tender_5434,383328,4599236,505215,864376,370042,6722197,41.0,5.9
Tender_5435,4735809,1933199,2591476,628771,63842,9953097,34.33,6.57
Tender_5436,2019768,450339,103172,390172,72199,3035650,42.67,5.73
Tender_5437,1845723,2089659,1229622,118036,57259,5340299,36.0,6.4
Tender_5438,8473533,1983914,2107872,776499,247034,13588852,34.33,6.57
Tender_5439,9680060,2964952,1916002,837725,402739,15801478,42.33,5.77
Tender_5440,8050794,528617,565963,256232,72058,9473664,23.33,7.67
Tender_5441,558114,328697,2193660,185051,381237,3646759,24.67,7.53
Tender_5442,5765582,1903452,1864649,690535,493937,10718155,22.33,7.77
Tender_5443,7837105,3824344,2980988,68329,151808,14862574,38.0,6.2
Tender_5444,9923552,3322952,2041560,640380,127524,16055968,28.33,7.17
Tender_5445,7712913,3400251,1000563,801281,433648,13348656,23.67,7.63
Tender_5446,3832037,427683,68442,822484,147019,5297665,36.0,6.4
Tender_5447,1872581,383235,2238248,860837,369521,5724422,38.0,6.2
Tender_5448,543193,1607329,1554178,930703,248270,4883673,26.67,7.33
Tender_5449,8658607,4457829,2682150,536681,354440,16689707,54.67,4.53
Tender_5450,1075756,2729257,1670543,169087,342973,5987616,18.67,8.13
Tender_5451,3107413,2848842,786150,300089,372314,7414808,43.33,5.67
Tender_5452,8387054,606597,1637573,512739,159643,11303606,47.0,5.3
Tender_5453,1368064,1849863,801133,834739,455580,5309379,21.33,7.87
Tender_5454,4026308,4759766,995867,720324,465362,10967627,38.67,6.13
Tender_5455,7282635,2450217,2634431,272110,464237,13103630,28.33,7.17
Tender_5456,2987201,3782423,2729168,628610,110183,10237585,35.33,6.47
Tender_5457,3254532,774799,804773,620879,413082,5868065,24.67,7.53
Tender_5458,5528307,154814,1171825,343619,484307,7682872,30.67,6.93
Tender_5459,6365384,3620964,412558,683343,453151,11535400,27.0,7.3
Tender_5460,8356512,4429596,1541407,383835,495679,15207029,41.0,5.9
Tender_5461,8929635,4241002,421294,591415,437357,14620703,47.67,5.23
Tender_5462,4936335,1722662,1062097,249238,211712,8182044,28.0,7.2
Tender_5463,1405276,724004,1238391,766268,219896,4353835,19.0,8.1
Tender_5464,9659918,4026905,2863260,897706,249553,17697342,31.0,6.9
Tender_5465,355268,2177085,222831,892188,415543,4062915,38.0,6.2
Tender_5466,4381038,3717494,399438,319763,274759,9092492,54.67,4.53
Tender_5467,2693708,3857276,1991231,300874,131831,8974920,39.33,6.07
Tender_5468,2353664,1350116,1199792,386825,218777,5509174,54.33,4.57
Tender_5469,2445320,2189262,2593586,635903,146839,8010910,38.67,6.13
Tender_5470,1443661,761024,2845972,361061,486509,5898227,44.67,5.53
Tender_5471,2160902,588016,2883235,685133,328128,6645414,45.0,5.5
Tender_5472,3898464,1107997,1988419,567041,140858,7702779,26.0,7.4
Tender_5473,8703512,354592,478074,746043,381998,10664219,33.0,6.7
Tender_5474,8725435,2527309,907272,783568,238214,13181798,38.67,6.13
Tender_5475,7356587,3064094,2725126,233984,103670,13483461,41.33,5.87
Tender_5476,1341084,4943102,2990745,820040,381538,10476509,34.33,6.57
Tender_5477,9509396,3998156,1866549,808545,249989,16432635,37.67,6.23
Tender_5478,6991722,3077715,1137114,557777,208706,11973034,52.33,4.77
Tender_5479,7470789,971715,374099,538427,441326,9796356,33.67,6.63
Tender_5480,707082,2192413,587876,655603,250059,4393033,35.0,6.5
Tender_5481,8123282,356422,1396155,145758,430214,10451831,56.67,4.33
Tender_5482,443265,1014780,1177058,272365,497472,3404940,42.33,5.77
Tender_5483,5375905,1489419,545548,377616,481626,8270114,33.33,6.67
Tender_5484,1539023,184305,2229629,423679,477286,4853922,46.0,5.4
Tender_5485,9958899,4286463,2523721,936228,489756,18195067,44.33,5.57
Tender_5486,5599648,1975716,1482193,102440,223886,9383883,43.33,5.67
Tender_5487,8520242,288899,125782,656036,167650,9758609,32.33,6.77
Tender_5488,2875517,4662817,2241573,346108,389816,10515831,48.0,5.2
Tender_5489,4440438,752446,524732,917092,50299,6685007,52.33,4.77
Tender_5490,1688510,3251542,2900375,636522,95138,8572087,38.0,6.2
Tender_5491,7095887,1779755,1722382,307521,372016,11277561,38.0,6.2
Tender_5492,9552161,2523694,1183759,200823,148880,13609317,46.0,5.4
Tender_5493,5914239,4300934,2367519,455388,332523,13370603,37.33,6.27
Tender_5494,8716068,1059495,2063456,130060,206290,12175369,47.0,5.3
Tender_5495,4493117,794570,2952065,463855,403701,9107308,21.33,7.87
Tender_5496,6077738,276195,2035792,551137,184597,9125459,24.33,7.57
Tender_5497,3700276,2944336,896380,447323,64065,8052380,39.67,6.03
Tender_5498,6742917,270841,2553347,327890,210186,10105181,48.0,5.2
Tender_5499,9705214,1228431,2046289,402582,283569,13666085,30.0,7.0
Tender_5500,8732366,3979881,2722575,478709,421630,16335161,46.33,5.37
Tender_5501,1442111,1502739,2404365,610766,429493,6389474,34.33,6.57
Tender_5502,850548,2872172,1647202,953802,286861,6610585,35.67,6.43
Tender_5503,6060162,3777273,1368382,552359,422021,12180197,46.33,5.37
Tender_5504,3549272,3931587,477730,839380,236503,9034472,58.0,4.2
Tender_5505,5386362,1546682,1939604,840985,96811,9810444,34.33,6.57
Tender_5506,356747,3736568,2462344,700437,238853,7494949,22.33,7.77
Tender_5507,6301152,799743,923319,952870,138664,9115748,46.67,5.33
Tender_5508,3924474,2769554,2396985,370483,424711,9886207,38.33,6.17
Tender_5509,5130863,4558811,2754772,467470,213902,13125818,28.67,7.13
Tender_5510,8536540,2694916,1536360,626375,266349,13660540,28.33,7.17
Tender_5511,4996637,2133405,2974021,442635,251242,10797940,32.67,6.73
Tender_5512,9764007,3346720,632855,513137,144701,14401420,46.67,5.33
Tender_5513,3265117,1042710,1571359,457994,337101,6674281,33.33,6.67
Tender_5514,3759362,1461245,653946,537480,320863,6732896,45.0,5.5
Tender_5515,897917,4262833,2903651,908852,215230,9188483,35.33,6.47
Tender_5516,9255044,1694951,1979420,783938,130141,13843494,48.0,5.2
Tender_5517,1307353,3039391,1280997,585448,238268,6451457,47.33,5.27
Tender_5518,1042162,4808535,2926670,801896,165113,9744376,33.0,6.7
Tender_5519,8104036,3104162,1950125,464672,453314,14076309,29.33,7.07
Tender_5520,9982440,4668987,94895,828998,74249,15649569,31.67,6.83
Tender_5521,4097763,1329329,1227396,809841,142972,7607301,40.33,5.97
Tender_5522,4734602,2533470,1642615,307126,97096,9314909,33.33,6.67
Tender_5523,6140597,1734275,1429681,328923,263791,9897267,32.33,6.77
Tender_5524,7013853,2600673,1943751,86595,302404,11947276,44.67,5.53
Tender_5525,6200597,4507906,430276,419721,152096,11710596,31.33,6.87
Tender_5526,1399983,1382108,2720410,607351,329209,6439061,45.33,5.47
Tender_5527,3964500,1296849,1967908,200796,51570,7481623,34.33,6.57
Tender_5528,642717,4502110,993327,841493,209545,7189192,35.0,6.5
Tender_5529,8074781,160241,2722511,772412,285667,12015612,44.67,5.53
Tender_5530,3026867,4374287,1900214,691972,265043,10258383,28.0,7.2
Tender_5531,6712742,2883948,1969947,86946,287393,11940976,40.67,5.93
Tender_5532,7828991,3857286,2711522,689821,490839,15578459,45.0,5.5
Tender_5533,5241207,3293548,2890879,734988,436915,12597537,30.67,6.93
Tender_5534,5608143,1513960,330651,887998,298152,8638904,38.67,6.13
Tender_5535,4378187,1871388,1561079,942209,468516,9221379,43.0,5.7
Tender_5536,3977001,3328671,1952366,540872,333760,10132670,47.33,5.27
Tender_5537,6498616,1533078,2293966,101223,390353,10817236,21.33,7.87
Tender_5538,2411779,2088951,2743870,825053,178932,8248585,31.0,6.9
Tender_5539,5517434,4932392,1905695,940189,369002,13664712,43.33,5.67
Tender_5540,9827309,791415,797565,366342,78685,11861316,31.0,6.9
Tender_5541,9679833,3538584,2440121,718758,94553,16471849,33.0,6.7
Tender_5542,1511812,984620,2883329,493143,313816,6186720,49.33,5.07
Tender_5543,7594027,2197099,1022975,883622,159511,11857234,29.0,7.1
Tender_5544,9431236,2943230,58830,595557,417502,13446355,48.67,5.13
Tender_5545,691858,116552,1690196,268460,466064,3233130,20.0,8.0
Tender_5546,3258052,1297691,69075,239601,326715,5191134,36.67,6.33
Tender_5547,8267579,2704361,2310636,209405,197519,13689500,26.33,7.37
Tender_5548,1851327,4573780,2444795,535271,439967,9845140,34.0,6.6
Tender_5549,5523984,2981231,2380109,271760,196879,11353963,40.0,6.0
Tender_5550,3320739,2763653,393045,763942,80233,7321612,31.33,6.87
Tender_5551,2532752,1582000,2624385,842576,169054,7750767,41.33,5.87
Tender_5552,7792868,2923925,793440,427186,411665,12349084,21.67,7.83
Tender_5553,4138222,3379481,123292,661476,461139,8763610,30.33,6.97
Tender_5554,8282398,4412905,2555203,838535,376878,16465919,27.67,7.23
Tender_5555,2906235,3842503,845389,348544,79081,8021752,50.67,4.93
Tender_5556,2538462,532798,2170258,569254,100425,5911197,42.67,5.73
Tender_5557,7139086,4507090,758677,138823,76661,12620337,22.67,7.73
Tender_5558,3548469,4594937,2478194,371952,154606,11148158,41.67,5.83
Tender_5559,9058425,437840,1820154,744899,377816,12439134,30.33,6.97
Tender_5560,7282909,3387261,922179,425662,205592,12223603,35.67,6.43
Tender_5561,2073137,1832675,1620331,830600,372100,6728843,45.0,5.5
Tender_5562,8048636,3035515,1361516,403538,77176,12926381,43.33,5.67
Tender_5563,2049216,4122526,2996393,968518,148203,10284856,28.0,7.2
Tender_5564,6580575,1292630,1021891,300920,144087,9340103,42.0,5.8
Tender_5565,9629829,4959231,765747,717203,464290,16536300,46.0,5.4
Tender_5566,1261514,4324176,1446831,371026,222467,7626014,31.0,6.9
Tender_5567,3435498,4708836,2158904,744732,224969,11272939,28.0,7.2
Tender_5568,9401709,1334196,2081967,83028,363991,13264891,33.0,6.7
Tender_5569,3378993,463339,2347580,164969,78928,6433809,24.67,7.53
Tender_5570,5891144,2997469,2240749,99707,442407,11671476,52.67,4.73
Tender_5571,9016870,2659676,2133370,652867,262902,14725685,50.67,4.93
Tender_5572,1940071,884210,112331,653684,85266,3675562,28.67,7.13
Tender_5573,8457704,2107469,626987,634553,493876,12320589,43.67,5.63
Tender_5574,8704394,4024733,610078,769421,325635,14434261,37.33,6.27
Tender_5575,1789483,1542981,330667,463303,341807,4468241,29.0,7.1
Tender_5576,689441,4685666,640258,799388,419002,7233755,22.0,7.8
Tender_5577,6221660,1592714,2707670,485822,297950,11305816,32.67,6.73
Tender_5578,2773276,909551,1161820,734872,498764,6078283,31.67,6.83
Tender_5579,5201069,1583395,1123142,804788,123139,8835533,36.0,6.4
Tender_5580,5580143,3778517,1779620,832438,116051,12086769,42.0,5.8
Tender_5581,408745,801049,1356073,321666,162342,3049875,52.0,4.8
Tender_5582,3353917,3451257,481656,515228,385260,8187318,23.33,7.67
Tender_5583,5468579,2479595,1830663,649150,381684,10809671,38.0,6.2
Tender_5584,7810906,2045577,515326,686644,236364,11294817,39.33,6.07
Tender_5585,9178990,1027637,2809904,753408,392831,14162770,33.33,6.67
Tender_5586,3750272,3475085,1645313,745141,172619,9788430,32.0,6.8
Tender_5587,6347743,2903595,1650407,63117,438582,11403444,43.33,5.67
Tender_5588,5412258,4701608,2649666,908735,75470,13747737,44.67,5.53
Tender_5589,3185388,592078,2800703,526359,167452,7271980,31.33,6.87
Tender_5590,1399249,606493,2826975,795888,165801,5794406,42.33,5.77
Tender_5591,2154159,3543884,1173169,250939,265428,7387579,52.67,4.73
Tender_5592,3557169,4482349,1467586,542138,301904,10351146,34.33,6.57
Tender_5593,5872261,2323131,2434356,69682,353878,11053308,35.67,6.43
Tender_5594,8143020,724655,1358736,778062,337151,11341624,41.67,5.83
Tender_5595,6825935,739665,2172896,853984,178042,10770522,38.33,6.17
Tender_5596,1737724,3684685,922512,515092,139970,6999983,27.33,7.27
Tender_5597,5399992,386482,173198,836382,317135,7113189,31.33,6.87
Tender_5598,4592835,1480673,2049200,767553,402522,9292783,33.33,6.67
Tender_5599,5178765,554912,1201814,334924,347706,7618121,45.0,5.5
Tender_5600,587852,628511,422588,917567,102096,2658614,24.33,7.57
Tender_5601,1214430,1516392,953678,259630,253309,4197439,26.67,7.33
Tender_5602,5716830,1314645,2498547,336531,269110,10135663,57.67,4.23
Tender_5603,7879445,991798,2513443,576260,445393,12406339,31.67,6.83
Tender_5604,9746118,1246910,543277,514418,92787,12143510,45.0,5.5
Tender_5605,8381291,3080008,2945602,413169,118563,14938633,49.33,5.07
Tender_5606,9404256,4624979,1287842,770352,251499,16338928,51.67,4.83
Tender_5607,5281321,2683059,2932134,996629,478466,12371609,49.33,5.07
Tender_5608,3900831,4219692,1533849,91402,389776,10135550,48.33,5.17
Tender_5609,1588947,1381595,1139486,72172,324409,4506609,42.67,5.73
Tender_5610,5920215,2083213,2966555,835975,474527,12280485,39.67,6.03
Tender_5611,3075646,4492301,593256,237534,106526,8505263,22.0,7.8
Tender_5612,2929573,3965907,662559,970332,107407,8635778,42.33,5.77
Tender_5613,8341468,2712528,2188519,642198,378727,14263440,29.0,7.1
Tender_5614,1614452,4419776,2493336,993847,441817,9963228,40.33,5.97
Tender_5615,2048975,2492101,2027890,586596,329041,7484603,34.0,6.6
Tender_5616,417946,4347557,1163552,104497,146113,6179665,37.33,6.27
Tender_5617,8022983,4889358,934385,960613,392614,15199953,25.0,7.5
Tender_5618,5317052,2006642,1128372,679895,210980,9342941,35.33,6.47
Tender_5619,7495504,3529366,2080261,481731,351093,13937955,38.0,6.2
Tender_5620,6088819,4884671,1730566,393977,415164,13513197,44.0,5.6
Tender_5621,5920892,4344421,697102,989894,429403,12381712,55.0,4.5
Tender_5622,878168,230071,2531983,404774,150918,4195914,48.33,5.17
Tender_5623,7008890,1177587,1832048,646090,429436,11094051,36.67,6.33
Tender_5624,6398992,1500364,457709,85016,129715,8571796,51.0,4.9
Tender_5625,4171028,2918797,351174,350122,338289,8129410,44.33,5.57
Tender_5626,362793,487421,2844906,235239,440643,4371002,36.33,6.37
Tender_5627,3211480,4819063,1896154,807031,405386,11139114,35.33,6.47
Tender_5628,313572,983533,549950,117959,160722,2125736,43.0,5.7
Tender_5629,627969,1918874,1045717,765368,133733,4491661,36.0,6.4
Tender_5630,7305699,3233717,2623691,452077,222818,13838002,58.0,4.2
Tender_5631,9214947,4018491,1688788,917343,218586,16058155,46.33,5.37
Tender_5632,6996850,4814140,232899,587627,288790,12920306,39.0,6.1
Tender_5633,6021448,866691,2372580,392300,391668,10044687,38.33,6.17
Tender_5634,2929706,1905804,864412,137127,202754,6039803,36.67,6.33
Tender_5635,3365911,4042112,2219403,978032,204350,10809808,21.67,7.83
Tender_5636,2825209,2342362,2529432,881327,211152,8789482,50.0,5.0
Tender_5637,1046429,1623667,583028,504644,225818,3983586,43.33,5.67
Tender_5638,5287715,989387,336830,256613,379760,7250305,33.33,6.67
Tender_5639,2480639,2653488,1874595,415962,269453,7694137,50.0,5.0
Tender_5640,571803,758958,1845315,565813,354192,4096081,33.0,6.7
Tender_5641,5049422,2756879,697811,571155,174522,9249789,43.33,5.67
Tender_5642,2879695,4045454,592694,212989,244469,7975301,55.67,4.43
Tender_5643,2684929,290704,1215994,57141,330631,4579399,55.0,4.5
Tender_5644,4872877,4861809,354159,598463,168711,10856019,24.67,7.53
Tender_5645,8000091,3241731,1647829,658318,245921,13793890,35.33,6.47
Tender_5646,361139,1210515,1606725,535334,181334,3895047,33.33,6.67
Tender_5647,4589078,1127353,1750896,963319,90763,8521409,40.0,6.0
Tender_5648,2825954,610857,2041333,699659,81702,6259505,31.67,6.83
Tender_5649,8956724,2330228,880576,159920,422354,12749802,38.67,6.13
Tender_5650,5168157,3484850,2180134,729330,153664,11716135,39.33,6.07
Tender_5651,8606574,140022,2829953,988408,136792,12701749,29.33,7.07
Tender_5652,5505066,2978231,2916513,581625,434915,12416350,32.0,6.8
Tender_5653,1014976,4598958,1849891,616316,278653,8358794,46.0,5.4
Tender_5654,1463590,4848287,2369661,304535,292366,9278439,52.67,4.73
Tender_5655,3575051,1475407,100161,479088,340023,5969730,35.33,6.47
Tender_5656,6969182,3491893,1419647,133871,337906,12352499,53.33,4.67
Tender_5657,8296157,1101736,1879049,503551,490788,12271281,41.67,5.83
Tender_5658,2511969,1026233,328763,367823,288105,4522893,39.0,6.1
Tender_5659,5161073,304744,84434,442918,496501,6489670,34.0,6.6
Tender_5660,5840603,2601384,1648177,753366,364427,11207957,35.67,6.43
Tender_5661,535821,2536878,741709,461312,271847,4547567,39.33,6.07
Tender_5662,9605589,4175614,573253,677700,496634,15528790,36.0,6.4
Tender_5663,4176966,3560416,1981280,753677,418874,10891213,57.67,4.23
Tender_5664,2562027,1015203,2924108,285508,270484,7057330,31.33,6.87
Tender_5665,1096162,2499628,1433865,982641,111584,6123880,29.33,7.07
Tender_5666,568947,4900672,1806689,684877,115280,8076465,30.33,6.97
Tender_5667,9056463,2328369,829248,623191,174239,13011510,29.33,7.07
Tender_5668,5522287,1774305,1840210,884240,51034,10072076,36.0,6.4
Tender_5669,9429239,2575082,2566898,811700,101603,15484522,27.67,7.23
Tender_5670,7627453,209874,668059,188496,473809,9167691,46.67,5.33
Tender_5671,5619747,3013310,916082,124702,181972,9855813,37.67,6.23
Tender_5672,2629768,622686,986573,464094,198807,4901928,28.33,7.17
Tender_5673,1288817,763670,2393206,139004,207037,4791734,28.67,7.13
Tender_5674,9754440,2037528,969396,178071,201690,13141125,50.0,5.0
Tender_5675,3994811,3583833,1083464,961404,110221,9733733,45.0,5.5
Tender_5676,2884905,4297688,324494,979226,75360,8561673,35.67,6.43
Tender_5677,6628739,946713,670970,677475,210779,9134676,57.67,4.23
Tender_5678,5193101,2665978,1333855,655117,344630,10192681,25.0,7.5
Tender_5679,4842819,3210430,1804865,405960,439229,10703303,51.0,4.9
Tender_5680,6491466,3912307,2076713,594892,268591,13343969,38.0,6.2
Tender_5681,5340622,2739869,1623151,798821,328456,10830919,20.0,8.0
Tender_5682,3886122,2258776,2141008,592498,375010,9253414,33.0,6.7
Tender_5683,1861271,3139690,2135349,847724,60779,8044813,42.33,5.77
Tender_5684,529090,1509394,863062,219383,273492,3394421,35.67,6.43
Tender_5685,2312631,1945953,1887566,340497,166362,6653009,36.33,6.37
Tender_5686,2147361,2750129,2464367,191608,289654,7843119,30.33,6.97
Tender_5687,2459080,3205150,2303535,780691,493373,9241829,43.33,5.67
Tender_5688,652374,4400177,2372323,746980,257909,8429763,37.33,6.27
Tender_5689,9663696,4017436,2532116,512081,257432,16982761,26.67,7.33
Tender_5690,8410364,1153302,133623,731804,86469,10515562,33.67,6.63
Tender_5691,7509683,4987274,60855,886084,432649,13876545,56.33,4.37
Tender_5692,5930134,2748837,2840278,952702,188828,12660779,49.67,5.03
Tender_5693,8918012,3162108,2161527,877079,183516,15302242,37.67,6.23
Tender_5694,3791194,125723,1327474,608333,416467,6269191,38.67,6.13
Tender_5695,6221864,3039869,2757969,825574,328233,13173509,28.67,7.13
Tender_5696,8470201,3159856,929306,120248,361057,13040668,38.0,6.2
Tender_5697,2113728,1333174,2202771,935943,78288,6663904,29.67,7.03
Tender_5698,8088414,2451616,1217419,944021,254354,12955824,36.33,6.37
Tender_5699,8941037,674711,2404896,832880,215746,13069270,50.67,4.93
Tender_5700,7303798,931984,1615837,85790,354230,10291639,21.33,7.87
Tender_5701,2481823,126879,543413,612769,170237,3935121,29.33,7.07
Tender_5702,415707,4457904,1595931,308299,288098,7065939,37.67,6.23
Tender_5703,8939231,4182463,2939313,107835,376248,16545090,37.33,6.27
Tender_5704,3085556,833386,2603885,107755,168488,6799070,33.0,6.7
Tender_5705,7868271,2821214,1633933,839427,488619,13651464,37.67,6.23
Tender_5706,9910860,2662443,2542611,81311,50877,15248102,45.0,5.5
Tender_5707,9878421,187383,2362212,551463,83114,13062593,35.0,6.5
Tender_5708,8502080,4831851,481966,923757,161504,14901158,39.33,6.07
Tender_5709,3420132,1522208,931476,426835,467818,6768469,41.33,5.87
Tender_5710,4406919,1547500,601117,302808,408628,7266972,31.0,6.9
Tender_5711,9533359,1736927,749553,994632,405949,13420420,40.0,6.0
Tender_5712,3774785,2527575,2851934,556838,103137,9814269,37.67,6.23
Tender_5713,3124139,3532933,319654,955145,81510,8013381,28.67,7.13
Tender_5714,9767683,3443697,757028,141822,225027,14335257,45.33,5.47
Tender_5715,4432051,1508482,1245753,907359,426217,8519862,31.67,6.83
Tender_5716,8918155,3880232,2437172,347556,460001,16043116,41.67,5.83
Tender_5717,476706,1438693,1564892,225331,290955,3996577,38.0,6.2
Tender_5718,8460843,3175355,1198894,220837,106835,13162764,24.67,7.53
Tender_5719,4648568,2571100,867838,545065,275880,8908451,44.67,5.53
Tender_5720,2559803,4744742,2870551,470226,450505,11095827,45.67,5.43
Tender_5721,6945958,1977481,745067,673276,347770,10689552,23.33,7.67
Tender_5722,8635423,3060815,2497174,922410,431693,15547515,39.0,6.1
Tender_5723,347873,2402795,2430680,98155,367511,5647014,25.33,7.47
Tender_5724,2202187,3210163,153375,816331,208848,6590904,23.0,7.7
Tender_5725,7705694,2756957,836653,303974,168034,11771312,30.0,7.0
Tender_5726,6108892,3910944,690374,508140,345821,11564171,36.67,6.33
Tender_5727,1223261,1668149,1450897,225407,95541,4663255,45.0,5.5
Tender_5728,1799142,3719704,946532,460061,421773,7347212,46.67,5.33
Tender_5729,8019719,1837038,1815140,979849,325784,12977530,31.0,6.9
Tender_5730,8216831,2622765,502390,896254,460892,12699132,51.67,4.83
Tender_5731,6041060,4456572,1357442,337493,433835,12626402,37.67,6.23
Tender_5732,4859538,3242658,1218788,337581,221704,9880269,31.67,6.83
Tender_5733,7773866,2916635,983037,282559,452030,12408127,36.67,6.33
Tender_5734,6034837,166464,2244086,290746,445278,9181411,34.0,6.6
Tender_5735,743249,502546,2857010,904233,254188,5261226,35.67,6.43
Tender_5736,3898255,1396589,86768,185623,344094,5911329,58.0,4.2
Tender_5737,1477843,2194097,1494072,904626,278163,6348801,33.67,6.63
Tender_5738,7216180,355066,347079,527878,447212,8893415,32.33,6.77
Tender_5739,8842403,3972169,1399166,620100,297763,15131601,37.67,6.23
Tender_5740,2256122,1430035,2166555,880715,206883,6940310,33.67,6.63
Tender_5741,6200906,3275620,2535621,597234,391511,13000892,35.33,6.47
Tender_5742,7879243,3933389,1436189,410297,336639,13995757,40.33,5.97
Tender_5743,3409124,4618182,2853884,424419,392968,11698577,44.33,5.57
Tender_5744,7370693,1424683,812241,557618,197984,10363219,49.0,5.1
Tender_5745,7387353,4644693,1930557,317639,285270,14565512,34.33,6.57
Tender_5746,5418416,3426615,2069330,758677,223647,11896685,43.33,5.67
Tender_5747,435148,3276692,2216321,847207,322242,7097610,29.67,7.03
Tender_5748,7201145,765404,974558,665389,254981,9861477,40.33,5.97
Tender_5749,9596737,4904763,1275382,184981,433144,16395007,49.0,5.1
Tender_5750,312114,4354098,308118,914342,126206,6014878,33.0,6.7
Tender_5751,2141834,1247468,1256411,450054,486565,5582332,39.33,6.07
Tender_5752,3145933,4394842,2983052,862308,443617,11829752,55.0,4.5
Tender_5753,635246,2848373,1766294,201402,99038,5550353,34.0,6.6
Tender_5754,517265,307763,1806351,559187,324721,3515287,28.67,7.13
Tender_5755,3728246,2356151,1525124,530316,307644,8447481,51.0,4.9
Tender_5756,9699590,447422,286416,819834,223304,11476566,41.67,5.83
Tender_5757,547442,3613925,1250997,519740,198528,6130632,34.67,6.53
Tender_5758,9093455,1171738,1871940,266077,409461,12812671,46.33,5.37
Tender_5759,2247042,546420,2801169,68773,462822,6126226,31.67,6.83
Tender_5760,7927795,4875614,1081350,760292,61263,14706314,30.67,6.93
Tender_5761,1165731,2667494,2206348,190596,385655,6615824,39.67,6.03
Tender_5762,5352971,1936981,780463,261535,275348,8607298,31.0,6.9
Tender_5763,7633216,2469696,2995438,499005,444739,14042094,48.33,5.17
Tender_5764,7010156,1065828,2273495,97248,215951,10662678,38.0,6.2
Tender_5765,5882317,188308,795653,301735,304559,7472572,51.0,4.9
Tender_5766,5774307,1371585,1012919,157625,53568,8370004,29.33,7.07
Tender_5767,5179392,2059895,756959,493878,422475,8912599,42.33,5.77
Tender_5768,5045723,244166,1781876,427253,129160,7628178,43.0,5.7
Tender_5769,832848,988517,1793917,89077,493963,4198322,25.33,7.47
Tender_5770,9572452,1744172,2299712,588743,130816,14335895,47.0,5.3
Tender_5771,9265325,527739,212700,861302,203929,11070995,22.67,7.73
Tender_5772,9533781,1024691,2349781,521889,226007,13656149,45.33,5.47
Tender_5773,8599557,681658,1639184,967947,341151,12229497,36.33,6.37
Tender_5774,5825163,2148993,1692052,439723,231137,10337068,38.67,6.13
Tender_5775,380326,1263422,894149,411963,130542,3080402,32.33,6.77
Tender_5776,3507983,3362760,2953099,130674,288673,10243189,43.0,5.7
Tender_5777,8430366,2129576,394272,571172,309796,11835182,16.33,8.37
Tender_5778,2927093,2172575,1548954,280388,457976,7386986,36.33,6.37
Tender_5779,1332375,4616533,715237,913103,114522,7691770,42.0,5.8
Tender_5780,9818903,4732799,2736777,655094,477209,18420782,29.0,7.1
Tender_5781,3638669,3537595,2088872,683936,173677,10122749,49.33,5.07
Tender_5782,654132,4419101,461221,794349,57022,6385825,47.33,5.27
Tender_5783,5351409,2604158,1910314,189309,390459,10445649,27.33,7.27
Tender_5784,1741351,3522465,1903622,723284,233871,8124593,23.0,7.7
Tender_5785,9516397,3674160,1779733,87801,370637,15428728,31.67,6.83
Tender_5786,485985,3595270,1954635,840391,443784,7320065,60.33,3.97
Tender_5787,8923936,4550843,1258170,378963,296491,15408403,39.67,6.03
Tender_5788,5206787,3493727,1864593,930815,273945,11769867,37.0,6.3
Tender_5789,9553819,4148325,1685605,955242,107069,16450060,36.0,6.4
Tender_5790,2423340,1785226,758278,125195,490047,5582086,47.33,5.27
Tender_5791,7040519,2413842,2957747,755345,334077,13501530,40.67,5.93
Tender_5792,487448,4396088,211219,558598,393810,6047163,38.0,6.2
Tender_5793,4981524,1148031,855830,737009,441994,8164388,39.33,6.07
Tender_5794,7244419,3082261,1460930,539826,69655,12397091,47.0,5.3
Tender_5795,2830083,2110918,1771660,139823,110239,6962723,33.33,6.67
Tender_5796,1135213,4900091,2943467,584635,242097,9805503,27.33,7.27
Tender_5797,9433957,823540,1640654,627830,397997,12923978,25.0,7.5
Tender_5798,8577405,1634048,308639,627120,245641,11392853,22.67,7.73
Tender_5799,4091330,1512076,2417933,974722,115091,9111152,49.0,5.1
Tender_5800,9435628,786813,1157101,528829,159749,12068120,45.67,5.43
Tender_5801,5314979,220538,1195246,313819,149627,7194209,34.67,6.53
Tender_5802,3900247,2231483,1654978,673403,203619,8663730,53.0,4.7
Tender_5803,2529232,1715820,2617795,318191,101435,7282473,39.67,6.03
Tender_5804,3017745,3461633,2112651,322137,138944,9053110,23.67,7.63
Tender_5805,1872899,372098,2330708,982928,153255,5711888,41.33,5.87
Tender_5806,6344636,2756762,2490062,800635,428385,12820480,31.0,6.9
Tender_5807,6763948,3619006,1601380,235538,414090,12633962,44.0,5.6
Tender_5808,4069258,4891076,1509278,276805,83335,10829752,51.0,4.9
Tender_5809,5175491,563432,255226,176414,238254,6408817,25.33,7.47
Tender_5810,3540443,2345771,259766,591041,76437,6813458,35.67,6.43
Tender_5811,8356889,2093000,1121522,177240,404651,12153302,40.0,6.0
Tender_5812,7257770,3564581,2046220,119972,486882,13475425,39.33,6.07
Tender_5813,8652471,2642805,2660850,343166,158876,14458168,37.33,6.27
Tender_5814,2592964,2235229,1782437,109114,179940,6899684,30.67,6.93
Tender_5815,6080754,2258125,685097,733264,298402,10055642,45.0,5.5
Tender_5816,2353784,3294013,1764333,764643,489973,8666746,35.33,6.47
Tender_5817,4293130,2283727,609653,557811,385911,8130232,46.67,5.33
Tender_5818,8706176,2637468,1581614,303979,304402,13533639,31.0,6.9
Tender_5819,1802155,1254768,1931896,151738,303591,5444148,47.0,5.3
Tender_5820,5953652,654649,2265013,907320,398238,10178872,27.0,7.3
Tender_5821,4925443,738102,2635029,702732,408780,9410086,34.33,6.57
Tender_5822,8140486,217284,2090652,154800,488599,11091821,49.0,5.1
Tender_5823,5352051,3541473,1756870,787776,467317,11905487,52.0,4.8
Tender_5824,3717951,3816345,557422,772437,184033,9048188,47.67,5.23
Tender_5825,3068777,219141,2733734,754872,433668,7210192,46.0,5.4
Tender_5826,6177683,475572,1626712,668459,466247,9414673,19.67,8.03
Tender_5827,5659171,3119566,2757116,814581,295911,12646345,43.33,5.67
Tender_5828,7711101,1851266,2383165,513537,498446,12957515,42.67,5.73
Tender_5829,6136055,414959,663715,417163,205853,7837745,44.0,5.6
Tender_5830,5450018,2023637,2436490,839651,471594,11221390,36.0,6.4
Tender_5831,4190625,1535123,1751865,485412,278133,8241158,39.33,6.07
Tender_5832,9078978,3537930,2402234,828996,298173,16146311,39.33,6.07
Tender_5833,4044249,851944,2619449,601639,174344,8291625,44.0,5.6
Tender_5834,6278875,2939235,2826119,280961,438619,12763809,35.67,6.43
Tender_5835,724028,887681,2388340,234003,321701,4555753,47.33,5.27
Tender_5836,7507826,4759027,371945,471468,368091,13478357,49.67,5.03
Tender_5837,5979170,3967904,2417146,908768,267129,13540117,25.0,7.5
Tender_5838,4435733,960284,640661,899821,429561,7366060,39.0,6.1
Tender_5839,1406541,376998,2332513,553699,60804,4730555,47.0,5.3
Tender_5840,3368112,2258051,330194,67106,54329,6077792,31.33,6.87
Tender_5841,9843712,265749,63382,330669,75089,10578601,53.33,4.67
Tender_5842,706662,2663168,2173002,411395,152060,6106287,35.33,6.47
Tender_5843,8109619,2423732,1935892,830865,457877,13757985,23.67,7.63
Tender_5844,4799364,3690432,499805,505898,115952,9611451,41.67,5.83
Tender_5845,4415878,2294749,2096844,668496,66494,9542461,36.33,6.37
Tender_5846,4366833,3461448,2702524,637659,246853,11415317,32.0,6.8
Tender_5847,2339190,2019749,1714526,520828,257608,6851901,35.33,6.47
Tender_5848,9781541,4556613,2809867,964204,170489,18282714,36.33,6.37
Tender_5849,8336598,4939437,2331085,490557,89730,16187407,44.0,5.6
Tender_5850,9740967,4792255,695344,272403,473938,15974907,40.67,5.93
Tender_5851,2417265,4960748,535089,958865,474604,9346571,37.0,6.3
Tender_5852,244198,1371142,1514579,360039,379756,3869714,50.67,4.93
Tender_5853,3316618,1281742,1709797,592663,490197,7391017,48.67,5.13
Tender_5854,2493832,4439845,1397345,995819,473237,9800078,34.67,6.53
Tender_5855,3313226,2689151,2195764,932765,418219,9549125,35.0,6.5
Tender_5856,2270986,422836,2346644,464297,299278,5804041,42.33,5.77
Tender_5857,2624272,650503,1637968,400114,470342,5783199,22.67,7.73
Tender_5858,4141723,2682494,2358104,313248,408812,9904381,31.33,6.87
Tender_5859,7797064,2253725,135244,535356,294623,11016012,42.33,5.77
Tender_5860,338336,4170703,707704,888318,109440,6214501,23.67,7.63
Tender_5861,4054241,4893169,769078,797193,410249,10923930,44.0,5.6
Tender_5862,2818985,483403,1829971,946533,119522,6198414,50.33,4.97
Tender_5863,2515209,2940628,1007456,884818,462686,7810797,35.0,6.5
Tender_5864,9013043,4241632,1222134,945978,129901,15552688,38.33,6.17
Tender_5865,8614216,1939880,2034026,188223,460049,13236394,22.33,7.77
Tender_5866,9154345,2835254,494262,188569,339679,13012109,28.67,7.13
Tender_5867,8150885,4348587,1199621,268170,76066,14043329,23.0,7.7
Tender_5868,1193223,619060,2811370,991967,205730,5821350,34.0,6.6
Tender_5869,3236324,2887934,528701,106208,422358,7181525,15.67,8.43
Tender_5870,7478412,2358269,390190,251656,199035,10677562,33.0,6.7
Tender_5871,708937,1019463,2813533,79916,115935,4737784,30.0,7.0
Tender_5872,1171271,3717162,1030686,841116,196675,6956910,32.33,6.77
Tender_5873,6107491,2140082,1706846,596485,492079,11042983,48.67,5.13
Tender_5874,2531088,977251,1066367,396708,111999,5083413,34.0,6.6
Tender_5875,1225587,4389339,384152,691260,249908,6940246,27.33,7.27
Tender_5876,7304634,1442034,2882074,284535,271063,12184340,44.0,5.6
Tender_5877,2123322,3820620,2115927,625455,497136,9182460,31.0,6.9
Tender_5878,711651,3096444,1915365,985256,464536,7173252,44.0,5.6
Tender_5879,8995400,420390,1864494,630873,72848,11984005,21.33,7.87
Tender_5880,5019128,113943,807402,572419,444039,6956931,48.67,5.13
Tender_5881,2032811,3567623,1675990,88187,472675,7837286,46.0,5.4
Tender_5882,605620,4845520,70635,426771,305417,6253963,45.0,5.5
Tender_5883,6673225,1430786,453342,496904,139837,9194094,34.67,6.53
Tender_5884,9986996,960721,2234000,558967,362801,14103485,41.67,5.83
Tender_5885,8516051,2908907,1016000,501681,486326,13428965,39.67,6.03
Tender_5886,8151314,1690462,1558037,589332,426824,12415969,34.33,6.57
Tender_5887,7950752,307948,2046057,110471,375573,10790801,23.33,7.67
Tender_5888,5858004,224456,2402318,213914,487683,9186375,32.33,6.77
Tender_5889,3356262,2833346,1207125,901230,319846,8617809,50.67,4.93
Tender_5890,2540376,297323,571111,69815,459972,3938597,27.67,7.23
Tender_5891,4263889,3594579,1974921,262031,358974,10454394,43.67,5.63
Tender_5892,9416317,4156435,117434,320194,235143,14245523,29.67,7.03
Tender_5893,6791101,2492575,2309374,515053,228108,12336211,41.67,5.83
Tender_5894,3416086,4324957,2069581,757148,150934,10718706,44.0,5.6
Tender_5895,8326076,1137441,310098,233414,449638,10456667,32.67,6.73
Tender_5896,8094184,3838028,339070,891519,199874,13362675,26.0,7.4
Tender_5897,3648446,4606927,1139253,967574,222263,10584463,30.33,6.97
Tender_5898,6963032,4863715,1583267,305341,306201,14021556,48.33,5.17
Tender_5899,5158204,561574,85253,306055,232070,6343156,50.33,4.97
Tender_5900,2639242,1791170,1767277,142852,258417,6598958,27.33,7.27
Tender_5901,2151556,2065530,1557895,192231,327679,6294891,35.33,6.47
Tender_5902,7619560,373759,2390370,220932,482561,11087182,53.33,4.67
Tender_5903,9367448,2119435,71810,510003,466591,12535287,33.0,6.7
Tender_5904,5814103,2071291,1241558,974889,168438,10270279,31.33,6.87
Tender_5905,8107240,4148532,1705988,625393,205045,14792198,49.33,5.07
Tender_5906,2891922,3100114,2421253,110017,482113,9005419,36.33,6.37
Tender_5907,3039989,4386105,1389085,587276,326656,9729111,48.33,5.17
Tender_5908,8837178,982056,2034802,972308,144381,12970725,35.67,6.43
Tender_5909,523957,1902586,1429220,135723,389634,4381120,42.0,5.8
Tender_5910,4678026,110117,1591430,60885,124782,6565240,32.67,6.73
Tender_5911,3948882,938026,1383575,637408,284307,7192198,44.67,5.53
Tender_5912,6843772,1240521,801142,639326,300324,9825085,45.0,5.5
Tender_5913,1706070,852489,1641107,579728,326309,5105703,45.33,5.47
Tender_5914,7565291,3953623,2966595,876253,363964,15725726,24.33,7.57
Tender_5915,5145151,293204,1883164,533448,155063,8010030,41.0,5.9
Tender_5916,3340666,2486791,1879436,792574,185466,8684933,19.33,8.07
Tender_5917,3756135,2476728,1711674,114279,325207,8384023,23.67,7.63
Tender_5918,9500539,2810766,1117723,259633,181789,13870450,32.0,6.8
Tender_5919,1089464,3981100,2970289,372251,384723,8797827,38.0,6.2
Tender_5920,9178990,687099,336170,339175,169898,10711332,51.0,4.9
Tender_5921,7511712,4621972,1425027,376096,154850,14089657,33.67,6.63
Tender_5922,1690345,648457,1557173,596190,163776,4655941,30.33,6.97
Tender_5923,9952634,1833460,1969482,713162,151927,14620665,31.67,6.83
Tender_5924,1586282,2236749,112413,91374,261023,4287841,41.67,5.83
Tender_5925,8966118,1056848,2542834,985736,126222,13677758,34.0,6.6
Tender_5926,1098681,613815,2655205,811397,190160,5369258,44.33,5.57
Tender_5927,9819604,1647666,342416,536763,454219,12800668,38.33,6.17
Tender_5928,9241367,327584,2639426,997784,316541,13522702,51.33,4.87
Tender_5929,1944174,3756109,266475,546725,350131,6863614,40.0,6.0
Tender_5930,8161562,1083222,1972869,254183,76755,11548591,47.33,5.27
Tender_5931,5223260,3357599,2596120,847291,466523,12490793,43.33,5.67
Tender_5932,5553865,4858761,2402174,575368,52447,13442615,16.67,8.33
Tender_5933,5721634,925925,1222011,785924,60452,8715946,56.67,4.33
Tender_5934,2396704,4658298,1504346,287235,481692,9328275,31.0,6.9
Tender_5935,7740786,2893096,2717534,922026,101719,14375161,40.33,5.97
Tender_5936,5569560,1885225,374578,354180,362030,8545573,39.67,6.03
Tender_5937,3537569,3587701,1988177,415853,65125,9594425,45.33,5.47
Tender_5938,8518317,743254,1164428,248124,352314,11026437,53.0,4.7
Tender_5939,363829,578685,2855041,460731,157743,4416029,41.33,5.87
Tender_5940,604935,3575563,927761,390341,342284,5840884,41.67,5.83
Tender_5941,4417099,4288784,2241507,282681,298725,11528796,47.0,5.3
Tender_5942,2060006,337428,2367225,380837,473880,5619376,50.33,4.97
Tender_5943,768199,4031706,369446,670617,390654,6230622,25.0,7.5
Tender_5944,3107235,3422873,2254155,474560,263456,9522279,26.67,7.33
Tender_5945,3563821,3267797,2958386,628394,403965,10822363,39.0,6.1
Tender_5946,3877815,4134929,178184,813791,396088,9400807,39.0,6.1
Tender_5947,6686307,153356,1109803,382641,390988,8723095,23.33,7.67
Tender_5948,2886610,1652953,236052,791087,93937,5660639,33.67,6.63
Tender_5949,9620312,2820504,102446,467554,379257,13390073,30.0,7.0
Tender_5950,6545372,4536333,2535404,748021,397094,14762224,25.0,7.5
Tender_5951,5005268,1130675,1434992,575949,445554,8592438,53.33,4.67
Tender_5952,1521160,1184660,1725773,761557,212467,5405617,46.33,5.37
Tender_5953,1352352,4083306,911098,252234,293525,6892515,48.33,5.17
Tender_5954,6778537,980657,2871740,619669,150193,11400796,50.0,5.0
Tender_5955,2312278,4044026,2679692,928995,159383,10124374,26.0,7.4
Tender_5956,8433470,4138299,2411413,652421,145699,15781302,34.33,6.57
Tender_5957,8110276,2135433,1298889,65267,417361,12027226,41.67,5.83
Tender_5958,1029553,1426174,1147752,414935,115815,4134229,54.0,4.6
Tender_5959,4293050,3437730,1441002,96023,82041,9349846,21.33,7.87
Tender_5960,9458115,4621064,980063,384979,400873,15845094,42.0,5.8
Tender_5961,4106903,2843858,680345,214174,259633,8104913,31.67,6.83
Tender_5962,1391726,4246764,2788416,973150,439349,9839405,39.67,6.03
Tender_5963,3957576,4582581,709613,467799,401611,10119180,55.67,4.43
Tender_5964,7370059,694350,413370,841958,154840,9474577,40.33,5.97
Tender_5965,4531424,606526,2119665,583419,383946,8224980,42.33,5.77
Tender_5966,9963053,2988627,2825176,481783,167548,16426187,36.67,6.33
Tender_5967,546741,1179993,2244808,480099,350137,4801778,44.33,5.57
Tender_5968,4291835,4315414,1134946,879687,369861,10991743,38.0,6.2
Tender_5969,7444760,2535593,423395,560451,246088,11210287,42.0,5.8
Tender_5970,5692362,625946,1479411,449597,395870,8643186,39.33,6.07
Tender_5971,7757576,3533750,411225,435355,168654,12306560,33.67,6.63
Tender_5972,1464705,4727261,2781536,479824,197238,9650564,26.67,7.33
Tender_5973,7304107,3656664,1739340,332484,105106,13137701,42.67,5.73
Tender_5974,9053196,2060518,1776168,74773,53675,13018330,59.67,4.03
Tender_5975,8913538,717911,447161,468635,173531,10720776,42.67,5.73
Tender_5976,8410500,4297962,2098185,57192,465516,15329355,55.33,4.47
Tender_5977,2677943,3082294,1573427,61768,488234,7883666,38.0,6.2
Tender_5978,3916676,3216417,2438638,971492,458440,11001663,30.67,6.93
Tender_5979,1409199,1163033,1853095,644466,442488,5512281,20.33,7.97
Tender_5980,704001,2761438,838329,270662,441325,5015755,49.67,5.03
Tender_5981,1464744,3582196,406701,79176,185683,5718500,39.33,6.07
Tender_5982,854195,3943409,2818911,307627,426923,8351065,53.33,4.67
Tender_5983,1597726,3277653,913129,540611,236727,6565846,32.67,6.73
Tender_5984,9296545,4164949,1766245,374472,233203,15835414,51.33,4.87
Tender_5985,6049647,4628073,1202152,975478,413105,13268455,22.0,7.8
Tender_5986,6114658,3778607,892061,857102,428122,12070550,41.33,5.87
Tender_5987,4755828,122601,2965233,838912,230974,8913548,52.33,4.77
Tender_5988,389255,2795203,2805221,95988,79247,6164914,44.67,5.53
Tender_5989,6489342,2623063,2482003,822400,106075,12522883,25.67,7.43
Tender_5990,8335073,1130043,1712017,80932,188029,11446094,26.0,7.4
Tender_5991,4552422,779776,826249,711014,226720,7096181,48.67,5.13
Tender_5992,5006238,3651744,496189,816730,157178,10128079,48.67,5.13
Tender_5993,8857313,3293379,2727932,839693,79612,15797929,47.33,5.27
Tender_5994,8354579,885943,2592730,970033,404970,13208255,32.67,6.73
Tender_5995,583305,824931,2115491,505106,468229,4497062,35.33,6.47
Tender_5996,3899840,3101363,1642035,722567,304630,9670435,31.33,6.87
Tender_5997,9515953,1839613,1152134,284447,397718,13189865,56.33,4.37
Tender_5998,1640098,2520528,270997,693402,443559,5568584,35.67,6.43
Tender_5999,8538922,274367,865532,195134,391626,10265581,32.0,6.8
Tender_6000,1835860,2756414,2586927,331190,381564,7891955,34.0,6.6
Tender_6001,8314517,1312817,1016705,678824,164469,11487332,37.67,6.23
Tender_6002,4691184,2649965,663881,337365,444989,8787384,39.0,6.1
Tender_6003,8312893,1264536,2010966,987806,77012,12653213,34.67,6.53
Tender_6004,5080085,3660727,2953980,922234,65607,12682633,45.67,5.43
Tender_6005,573848,3552365,576638,627039,141422,5471312,28.0,7.2
Tender_6006,8155755,3715790,1901141,782720,120430,14675836,36.33,6.37
Tender_6007,3263199,4882916,2970979,330000,489112,11936206,25.67,7.43
Tender_6008,4288920,3841775,2714643,108027,471732,11425097,46.33,5.37
Tender_6009,2591702,3549064,1619343,295107,360385,8415601,43.67,5.63
Tender_6010,9023302,4431140,327534,154749,51813,13988538,26.67,7.33
Tender_6011,6408170,3683871,1240878,290560,78636,11702115,39.0,6.1
Tender_6012,3603686,4885029,664987,724534,402100,10280336,31.0,6.9
Tender_6013,4137784,185235,448858,308249,281053,5361179,40.33,5.97
Tender_6014,8311872,526628,1117129,596120,281132,10832881,46.0,5.4
Tender_6015,4368101,4020499,1429776,248133,177117,10243626,49.0,5.1
Tender_6016,6853732,4777828,1253063,546694,301402,13732719,30.33,6.97
Tender_6017,2656323,1565697,1895444,743498,395775,7256737,31.33,6.87
Tender_6018,3535278,4321088,2236602,892409,395766,11381143,42.33,5.77
Tender_6019,614473,1099420,318403,958248,468312,3458856,33.0,6.7
Tender_6020,5749850,3457652,1835794,540287,277318,11860901,36.67,6.33
Tender_6021,7660813,198974,2265646,334737,221885,10682055,25.67,7.43
Tender_6022,6932590,2293455,2534410,224950,245682,12231087,54.67,4.53
Tender_6023,2732262,1059443,1734301,628251,243458,6397715,29.0,7.1
Tender_6024,1041715,2144795,2909641,991102,68827,7156080,37.67,6.23
Tender_6025,7952317,4261464,1542842,330706,448242,14535571,34.0,6.6
Tender_6026,2995210,3657060,1516780,229414,201069,8599533,20.67,7.93
Tender_6027,6673863,2372180,667642,876587,210403,10800675,38.0,6.2
Tender_6028,7016414,449232,214839,603918,433373,8717776,32.67,6.73
Tender_6029,4269072,2533039,2304114,914458,497643,10518326,32.0,6.8
Tender_6030,2249633,4844675,1701949,390030,473183,9659470,50.0,5.0
Tender_6031,9144505,4136178,798234,141321,256230,14476468,42.67,5.73
Tender_6032,6332051,457718,205080,510309,450592,7955750,36.33,6.37
Tender_6033,8600848,1868403,1932249,707593,147024,13256117,40.33,5.97
Tender_6034,5897241,4727316,1644953,568681,140600,12978791,48.33,5.17
Tender_6035,3105827,2070690,1868367,971316,480544,8496744,43.33,5.67
Tender_6036,1899533,2658352,2461252,430719,56458,7506314,43.67,5.63
Tender_6037,8942064,896491,1179930,499319,448767,11966571,29.33,7.07
Tender_6038,7504719,123575,613546,394594,405704,9042138,52.67,4.73
Tender_6039,2582780,2099706,354189,467757,151282,5655714,33.33,6.67
Tender_6040,6398369,688974,1919983,913662,259635,10180623,23.67,7.63
Tender_6041,3919607,945900,175528,397589,365747,5804371,39.33,6.07
Tender_6042,6208264,709472,98022,613959,365073,7994790,47.67,5.23
Tender_6043,6741886,3200577,2862500,592248,360237,13757448,31.67,6.83
Tender_6044,3785753,3089527,268327,784218,225574,8153399,50.0,5.0
Tender_6045,9947394,4165979,444022,314809,298478,15170682,36.33,6.37
Tender_6046,4626684,4135762,2332113,480019,425740,12000318,30.33,6.97
Tender_6047,9215457,555155,2273226,666202,231778,12941818,34.0,6.6
Tender_6048,8454374,683552,2423105,775304,178656,12514991,26.67,7.33
Tender_6049,4930365,4618590,1199152,181061,488046,11417214,43.33,5.67
Tender_6050,3318544,1965119,1986651,622121,320685,8213120,28.0,7.2
Tender_6051,2444296,202977,2999185,136763,73060,5856281,34.67,6.53
Tender_6052,4466396,4061799,1499669,457265,386096,10871225,31.0,6.9
Tender_6053,3620022,4359335,1938720,395190,143807,10457074,27.33,7.27
Tender_6054,5100230,2664553,2403071,322418,368952,10859224,43.33,5.67
Tender_6055,1162432,269471,1713625,910008,356375,4411911,38.0,6.2
Tender_6056,3570657,4327810,731039,891123,360974,9881603,37.0,6.3
Tender_6057,4460757,1617138,314309,920018,104613,7416835,42.67,5.73
Tender_6058,2591594,2201406,2172706,957881,427895,8351482,30.0,7.0
Tender_6059,6678712,3005745,2801241,505132,463154,13453984,42.0,5.8
Tender_6060,2822255,3262656,150631,296756,421472,6953770,28.33,7.17
Tender_6061,7066156,214757,2269555,445438,147433,10143339,49.67,5.03
Tender_6062,3918514,2529824,507293,587648,382422,7925701,40.0,6.0
Tender_6063,5352165,2038284,2736033,812973,61274,11000729,40.67,5.93
Tender_6064,4472735,1375957,1765037,113283,118300,7845312,44.67,5.53
Tender_6065,5224979,306014,1050702,424095,323591,7329381,53.33,4.67
Tender_6066,9612111,1100797,1697658,222203,77086,12709855,35.33,6.47
Tender_6067,3728187,1750796,207081,318702,134361,6139127,27.67,7.23
Tender_6068,307396,470036,768062,393162,87363,2026019,39.67,6.03
Tender_6069,4413531,1367090,78116,522290,170224,6551251,28.33,7.17
Tender_6070,2070668,1176954,2455478,850419,140232,6693751,31.0,6.9
Tender_6071,505272,1750378,1766491,688136,408876,5119153,35.33,6.47
Tender_6072,6416832,4882126,575052,972636,261887,13108533,54.0,4.6
Tender_6073,5372063,2195021,2352412,405148,193742,10518386,23.67,7.63
Tender_6074,5858752,3015111,1822124,145241,418978,11260206,32.33,6.77
Tender_6075,9088404,2376040,2372998,509904,53628,14400974,39.67,6.03
Tender_6076,6740760,531520,2860241,97804,91976,10322301,49.33,5.07
Tender_6077,382502,2168540,1845808,443920,430387,5271157,33.0,6.7
Tender_6078,1377221,3233809,259850,723141,105846,5699867,32.67,6.73
Tender_6079,3982419,3882743,1125695,351821,256327,9599005,44.67,5.53
Tender_6080,7807998,786565,1198513,654867,268717,10716660,36.0,6.4
Tender_6081,8426492,2055319,65671,430030,123173,11100685,26.33,7.37
Tender_6082,3036660,1763860,2574712,208311,319374,7902917,32.33,6.77
Tender_6083,9448579,4797940,2840548,854043,374002,18315112,43.67,5.63
Tender_6084,6734265,2284639,2565128,732341,456104,12772477,31.33,6.87
Tender_6085,8575889,2213369,2513838,570320,128970,14002386,41.67,5.83
Tender_6086,5517765,4178846,2133354,447004,281933,12558902,52.0,4.8
Tender_6087,7481246,1444910,1517663,139231,350103,10933153,41.33,5.87
Tender_6088,6980777,4016394,1941106,453808,388964,13781049,30.0,7.0
Tender_6089,9214561,4730971,311475,416676,409097,15082780,29.33,7.07
Tender_6090,595840,716171,1868157,417211,176785,3774164,35.33,6.47
Tender_6091,8444111,1197175,539917,308001,422056,10911260,50.0,5.0
Tender_6092,3465684,1033383,2399186,195980,82757,7176990,28.0,7.2
Tender_6093,5394120,3371435,1622751,822130,332700,11543136,48.0,5.2
Tender_6094,5878388,2729403,455168,240167,98931,9402057,29.0,7.1
Tender_6095,7905079,4128809,1637260,713567,467714,14852429,44.67,5.53
Tender_6096,2286604,2047584,2190705,740465,470388,7735746,39.67,6.03
Tender_6097,591109,3202671,2153368,473678,405291,6826117,38.33,6.17
Tender_6098,7986695,814770,2678549,507839,237409,12225262,30.33,6.97
Tender_6099,1953783,2801657,1803980,316103,221909,7097432,32.0,6.8
Tender_6100,7884278,2512862,786188,233300,235344,11651972,40.33,5.97
Tender_6101,8803604,4857357,248046,496368,66455,14471830,24.33,7.57
Tender_6102,572562,3288188,1341782,773104,295567,6271203,28.67,7.13
Tender_6103,7049349,503584,941232,877625,340872,9712662,35.0,6.5
Tender_6104,6099287,3333042,2729018,989368,454330,13605045,43.0,5.7
Tender_6105,5630853,3735821,1946933,397461,272793,11983861,38.33,6.17
Tender_6106,828732,619516,2206297,123895,100396,3878836,32.33,6.77
Tender_6107,3085254,3855335,2212506,658499,463130,10274724,24.0,7.6
Tender_6108,7370621,3745760,427981,763596,425963,12733921,51.0,4.9
Tender_6109,5289466,3540078,2817592,541367,180334,12368837,46.33,5.37
Tender_6110,8191340,2333887,1377878,501897,406068,12811070,32.33,6.77
Tender_6111,2450930,4167794,2274165,195450,75373,9163712,53.33,4.67
Tender_6112,2440120,856298,444821,149030,327956,4218225,42.67,5.73
Tender_6113,3583629,1333314,1288444,946918,221370,7373675,46.33,5.37
Tender_6114,1488279,2385357,321994,794185,319278,5309093,32.67,6.73
Tender_6115,4586160,1855528,130418,829402,420090,7821598,53.33,4.67
Tender_6116,7114388,2526679,2310234,186769,442854,12580924,32.0,6.8
Tender_6117,5119643,3496496,2965474,462495,439031,12483139,49.0,5.1
Tender_6118,2787987,4814493,2349940,485324,239201,10676945,33.33,6.67
Tender_6119,973849,1950600,832284,986198,60740,4803671,29.0,7.1
Tender_6120,2744843,2301814,1679538,300927,402294,7429416,29.67,7.03
Tender_6121,413209,4520070,1396709,378865,78172,6787025,32.67,6.73
Tender_6122,7682523,2842909,645726,51608,110463,11333229,31.67,6.83
Tender_6123,6819171,2583412,1568236,384947,409736,11765502,34.33,6.57
Tender_6124,6211583,3923120,1919597,875039,284362,13213701,34.33,6.57
Tender_6125,8377113,2959925,1553464,953876,273305,14117683,39.0,6.1
Tender_6126,9823575,999295,2807543,930937,428480,14989830,34.0,6.6
Tender_6127,7424202,2856065,1825314,551713,351680,13008974,40.67,5.93
Tender_6128,6821799,4204532,2553547,52488,139240,13771606,21.33,7.87
Tender_6129,7836068,4490168,200119,397219,67174,12990748,40.67,5.93
Tender_6130,6056153,448236,1911926,656201,414334,9486850,42.67,5.73
Tender_6131,8960988,308478,2357113,844923,355891,12827393,17.33,8.27
Tender_6132,1552776,2731459,2873376,159803,374906,7692320,40.0,6.0
Tender_6133,3666850,4373627,766136,834947,475409,10116969,20.0,8.0
Tender_6134,5223615,2046192,881697,836430,443031,9430965,35.33,6.47
Tender_6135,4026231,1341261,2441405,864029,73406,8746332,34.33,6.57
Tender_6136,5170703,3642269,1160814,548428,292703,10814917,56.67,4.33
Tender_6137,4746786,4052701,1307902,578210,132740,10818339,46.33,5.37
Tender_6138,7976963,2098192,2273868,714303,444438,13507764,23.33,7.67
Tender_6139,7612762,3498030,2931129,561513,290700,14894134,43.0,5.7
Tender_6140,6577891,542350,249083,478437,335963,8183724,49.33,5.07
Tender_6141,3024870,3741763,2710363,477263,51015,10005274,47.67,5.23
Tender_6142,4090422,2044687,1124236,706053,377612,8343010,43.0,5.7
Tender_6143,6856103,594407,2275722,273682,434393,10434307,35.33,6.47
Tender_6144,9744178,690847,2059362,363775,56670,12914832,45.67,5.43
Tender_6145,6655823,3782831,938222,239481,478416,12094773,34.33,6.57
Tender_6146,7043172,4460302,1193502,624196,388140,13709312,38.33,6.17
Tender_6147,4357096,1399409,98993,897056,316259,7068813,40.33,5.97
Tender_6148,7690319,859206,1371222,285727,472470,10678944,30.33,6.97
Tender_6149,9420932,443199,1961153,262416,240039,12327739,36.0,6.4
Tender_6150,7372078,2923666,331941,196470,124409,10948564,41.0,5.9
Tender_6151,2208071,1589276,2001345,267874,229173,6295739,39.33,6.07
Tender_6152,3249919,4289454,2633606,820832,456023,11449834,31.67,6.83
Tender_6153,287705,4746900,2246114,825772,346082,8452573,32.0,6.8
Tender_6154,4578035,2142410,1481450,762453,201380,9165728,41.0,5.9
Tender_6155,6130484,2057654,1958159,746165,265295,11157757,46.0,5.4
Tender_6156,8481401,1607218,1483960,585320,153642,12311541,52.33,4.77
Tender_6157,8539221,4575413,905871,301175,69022,14390702,36.67,6.33
Tender_6158,7079402,2887952,2521449,424095,432896,13345794,45.0,5.5
Tender_6159,8285317,3248577,1143550,507969,327669,13513082,41.33,5.87
Tender_6160,4437689,4804554,1737554,219735,350666,11550198,51.0,4.9
Tender_6161,1156655,2026826,888536,560497,274501,4907015,50.33,4.97
Tender_6162,4437282,2295675,1253641,825906,209768,9022272,39.67,6.03
Tender_6163,6048871,2769685,870863,793534,278554,10761507,32.33,6.77
Tender_6164,711440,1074943,316344,271467,350419,2724613,46.33,5.37
Tender_6165,6841898,733824,1597382,542277,247688,9963069,38.67,6.13
Tender_6166,2995663,3679984,802516,148309,146599,7773071,46.0,5.4
Tender_6167,6054509,747671,93292,141431,496962,7533865,37.0,6.3
Tender_6168,1627342,566584,2351271,646484,201474,5393155,22.33,7.77
Tender_6169,2285220,3320618,2749871,136776,494554,8987039,49.33,5.07
Tender_6170,1657120,3001348,832253,917421,148663,6556805,43.67,5.63
Tender_6171,6020694,868124,1577167,583060,450956,9500001,43.0,5.7
Tender_6172,6459580,2730832,2186205,763146,195308,12335071,49.67,5.03
Tender_6173,7394387,887315,258948,210777,107933,8859360,34.0,6.6
Tender_6174,5960858,1917929,2742781,952089,174826,11748483,35.0,6.5
Tender_6175,3177565,4421709,601930,962643,188690,9352537,34.67,6.53
Tender_6176,2561601,1357374,2525465,941139,375624,7761203,20.67,7.93
Tender_6177,7835843,1533602,2375012,55392,345339,12145188,21.0,7.9
Tender_6178,9513700,1482818,639598,831202,367652,12834970,38.0,6.2
Tender_6179,2287945,3583471,1438802,470834,442162,8223214,41.33,5.87
Tender_6180,3380424,1388832,417632,52885,126206,5365979,36.67,6.33
Tender_6181,6999153,1751441,1808235,361148,226121,11146098,32.67,6.73
Tender_6182,2612160,3278748,753768,420279,237418,7302373,47.67,5.23
Tender_6183,4535303,2946454,2294453,363313,203224,10342747,41.0,5.9
Tender_6184,9408983,4386053,397210,904767,357203,15454216,34.33,6.57
Tender_6185,380623,4696920,1704752,81146,235986,7099427,49.0,5.1
Tender_6186,4666716,2024672,1959484,683268,349187,9683327,39.0,6.1
Tender_6187,7472288,2402394,2780788,504465,244133,13404068,33.0,6.7
Tender_6188,8275273,3342759,830203,865847,142264,13456346,30.33,6.97
Tender_6189,8078324,497839,2862305,709192,344637,12492297,54.33,4.57
Tender_6190,3870272,2880754,1916172,936009,486533,10089740,31.33,6.87
Tender_6191,3539569,1360755,2648716,583435,373370,8505845,27.33,7.27
Tender_6192,9530670,378696,1626994,234476,467588,12238424,34.0,6.6
Tender_6193,4171263,2638440,1723104,264650,131824,8929281,28.0,7.2
Tender_6194,9982514,4687148,1204938,733513,98017,16706130,41.33,5.87
Tender_6195,5898706,4671087,345475,802187,275325,11992780,30.67,6.93
Tender_6196,1102313,1287801,72945,920486,430083,3813628,45.33,5.47
Tender_6197,2732798,2757581,258531,114709,306567,6170186,24.33,7.57
Tender_6198,7981170,1320396,352643,118162,120715,9893086,40.67,5.93
Tender_6199,9601951,3288097,612110,859984,118258,14480400,53.0,4.7
Tender_6200,6682899,4015511,2175457,132775,418570,13425212,31.0,6.9
Tender_6201,2831549,740180,1028354,267845,439577,5307505,53.33,4.67
Tender_6202,6664136,1717019,1160460,347437,178955,10068007,29.33,7.07
Tender_6203,3584821,4341949,1188961,620154,209308,9945193,34.33,6.57
Tender_6204,2015126,4303063,2643544,229636,66258,9257627,42.67,5.73
Tender_6205,4632964,3238479,743365,492004,143351,9250163,44.67,5.53
Tender_6206,1706277,864102,309926,436246,467125,3783676,41.0,5.9
Tender_6207,4033796,3074403,2821168,818616,473523,11221506,55.67,4.43
Tender_6208,5516690,4318968,2090361,398284,337117,12661420,41.67,5.83
Tender_6209,771205,3465446,2687597,138559,290310,7353117,35.0,6.5
Tender_6210,3437672,4938650,1029253,192552,358862,9956989,42.33,5.77
Tender_6211,7762050,2491117,329491,612156,395254,11590068,43.67,5.63
Tender_6212,8989342,417095,147314,725146,239033,10517930,44.0,5.6
Tender_6213,5457967,2604928,2185115,511856,290236,11050102,23.67,7.63
Tender_6214,1565349,4417233,961595,630366,149769,7724312,31.0,6.9
Tender_6215,5229297,4005573,2962215,857425,272769,13327279,40.0,6.0
Tender_6216,1389734,748204,2084231,252020,175357,4649546,32.67,6.73
Tender_6217,3163365,4533850,134116,962700,468294,9262325,45.33,5.47
Tender_6218,465141,4554248,2286029,341042,385258,8031718,36.0,6.4
Tender_6219,1322045,1254481,2621572,583134,487377,6268609,46.0,5.4
Tender_6220,1441635,777724,77770,831190,289140,3417459,35.67,6.43
Tender_6221,9961701,4016298,1470291,124003,214134,15786427,28.33,7.17
Tender_6222,609507,4577294,920630,723076,367095,7197602,33.67,6.63
Tender_6223,6656504,149810,2128652,652785,348950,9936701,51.67,4.83
Tender_6224,8482635,4267919,2119003,404782,220215,15494554,31.67,6.83
Tender_6225,8361343,3390521,2664883,550321,165530,15132598,43.0,5.7
Tender_6226,4060743,3617644,2467180,154982,120049,10420598,51.0,4.9
Tender_6227,7209121,929813,2287851,376907,191668,10995360,56.33,4.37
Tender_6228,9335481,3140953,1391714,890250,444405,15202803,42.33,5.77
Tender_6229,5556605,2232142,322362,803427,438597,9353133,44.67,5.53
Tender_6230,3134375,3099188,2609629,468852,250561,9562605,37.0,6.3
Tender_6231,4150990,4452894,1707233,295570,251539,10858226,38.33,6.17
Tender_6232,7829866,167711,1555127,687827,339161,10579692,26.33,7.37
Tender_6233,5402094,3684639,689160,549417,358982,10684292,32.0,6.8
Tender_6234,7988047,983780,2314829,79120,467712,11833488,43.33,5.67
Tender_6235,7173464,4465992,1285019,687702,260827,13873004,24.67,7.53
Tender_6236,2247355,3800254,1350642,63753,308954,7770958,60.0,4.0
Tender_6237,2139445,541368,1439198,255018,249696,4624725,26.33,7.37
Tender_6238,5807500,328599,1259451,397315,414476,8207341,34.33,6.57
Tender_6239,5942222,774990,305566,917033,448335,8388146,30.33,6.97
Tender_6240,9116196,1902460,1653608,868789,88123,13629176,38.0,6.2
Tender_6241,4948362,3567486,1199466,756835,163424,10635573,40.33,5.97
Tender_6242,9999972,2731897,2978632,415373,263216,16389090,31.33,6.87
Tender_6243,8214545,674215,2616730,888539,93574,12487603,47.33,5.27
Tender_6244,3402181,1335714,2099385,815505,289769,7942554,45.33,5.47
Tender_6245,8710300,1649147,2014217,225149,168810,12767623,39.0,6.1
Tender_6246,5290741,170150,1878619,706469,263208,8309187,26.33,7.37
Tender_6247,362999,631968,2319555,646268,451965,4412755,32.33,6.77
Tender_6248,253838,3633059,2602973,525452,480681,7496003,32.67,6.73
Tender_6249,8913501,1796317,2021216,105919,346917,13183870,45.67,5.43
Tender_6250,2064814,3128561,2521979,674822,422626,8812802,44.0,5.6
Tender_6251,1457862,3837956,2442629,472397,264176,8475020,45.67,5.43
Tender_6252,1242343,3404054,294944,396621,226717,5564679,38.33,6.17
Tender_6253,6180639,981782,941175,80358,183648,8367602,43.67,5.63
Tender_6254,2568870,2110930,668767,137686,78918,5565171,54.67,4.53
Tender_6255,1727989,3496336,971869,536501,380289,7112984,43.0,5.7
Tender_6256,3017684,2697355,2994844,543793,155193,9408869,43.33,5.67
Tender_6257,4637954,3839598,2255402,207769,218651,11159374,37.67,6.23
Tender_6258,549741,1630434,1302951,559640,275574,4318340,39.33,6.07
Tender_6259,8228497,2884795,2395078,300662,449909,14258941,48.67,5.13
Tender_6260,7298661,4695415,532317,272864,498935,13298192,39.0,6.1
Tender_6261,7118573,3087361,2475399,603102,319397,13603832,47.67,5.23
Tender_6262,8284073,3303641,1413232,792253,290306,14083505,45.0,5.5
Tender_6263,8971920,4660794,111743,264376,443579,14452412,38.33,6.17
Tender_6264,6544775,2365194,129624,227594,206784,9473971,43.67,5.63
Tender_6265,1901582,1583357,90015,660527,425814,4661295,41.33,5.87
Tender_6266,9120584,947721,465182,792369,120223,11446079,57.0,4.3
Tender_6267,6724502,1540737,1588450,548618,373127,10775434,47.33,5.27
Tender_6268,6596940,1189438,2977054,730026,90620,11584078,29.33,7.07
Tender_6269,5059463,4395275,2754655,488390,123082,12820865,46.33,5.37
Tender_6270,6128109,4542867,2435180,949373,354926,14410455,37.0,6.3
Tender_6271,3582736,2759266,2962465,702262,424732,10431461,36.67,6.33
Tender_6272,4284770,1845298,1676165,847974,451677,9105884,25.0,7.5
Tender_6273,8872020,2795214,2552438,148926,155215,14523813,36.0,6.4
Tender_6274,3545860,2208757,918831,165943,58918,6898309,44.67,5.53
Tender_6275,7846759,956258,2888550,971313,202895,12865775,39.33,6.07
Tender_6276,4009165,2289460,1531746,305067,153789,8289227,53.0,4.7
Tender_6277,3623662,2153778,1173027,148411,95225,7194103,37.0,6.3
Tender_6278,2260440,409855,398170,599829,92643,3760937,39.0,6.1
Tender_6279,966799,894157,2511164,856372,406326,5634818,44.67,5.53
Tender_6280,7564577,4932105,2174676,615058,411946,15698362,50.67,4.93
Tender_6281,5260547,2200946,2446508,308491,171340,10387832,42.67,5.73
Tender_6282,7547352,1598751,930510,288598,67244,10432455,26.0,7.4
Tender_6283,6909492,3420990,784135,450087,98457,11663161,29.67,7.03
Tender_6284,621609,3968962,225888,418144,126295,5360898,43.33,5.67
Tender_6285,3439815,2050316,2564978,796135,454735,9305979,44.33,5.57
Tender_6286,1646730,3451346,2388761,630783,87678,8205298,47.0,5.3
Tender_6287,871083,1717373,2471341,684150,465167,6209114,46.67,5.33
Tender_6288,8079460,1349024,2544599,340461,236442,12549986,47.67,5.23
Tender_6289,7641838,2834997,1086411,859189,240898,12663333,55.67,4.43
Tender_6290,7881139,994927,1838303,852082,73067,11639518,58.33,4.17
Tender_6291,3398187,3072430,1406798,211399,68567,8157381,24.0,7.6
Tender_6292,6365197,2098229,2530094,950719,111067,12055306,44.67,5.53
Tender_6293,4335960,864560,1423594,521668,298195,7443977,45.0,5.5
Tender_6294,4156459,467876,1374575,583982,381388,6964280,36.0,6.4
Tender_6295,9895575,2305562,755984,296683,458817,13712621,57.67,4.23
Tender_6296,7069497,1979139,1031941,634796,349113,11064486,40.0,6.0
Tender_6297,4624947,292983,1626373,132156,135531,6811990,38.33,6.17
Tender_6298,1528418,4647922,1815884,492057,122444,8606725,39.33,6.07
Tender_6299,4731376,336325,771341,954105,220550,7013697,35.33,6.47
Tender_6300,5380743,2542093,1756776,987363,483107,11150082,39.33,6.07
Tender_6301,1718329,2788353,1138033,367308,456616,6468639,21.33,7.87
Tender_6302,2963779,1958559,885959,423107,499033,6730437,35.33,6.47
Tender_6303,8267194,850150,1930984,287994,435875,11772197,49.33,5.07
Tender_6304,6396845,380816,2984709,542408,275110,10579888,36.67,6.33
Tender_6305,8250689,406745,1950153,468620,267078,11343285,46.33,5.37
Tender_6306,9742973,1531695,359332,506244,391759,12532003,48.33,5.17
Tender_6307,9190857,2818603,1378889,164768,192145,13745262,41.0,5.9
Tender_6308,9464776,478999,1962253,318408,90093,12314529,30.67,6.93
Tender_6309,432438,2574389,2965911,163800,326032,6462570,45.0,5.5
Tender_6310,3142596,3863813,2296633,635070,300820,10238932,48.33,5.17
Tender_6311,7876831,3220995,2519225,945235,463211,15025497,29.0,7.1
Tender_6312,2543427,2564555,2441539,796481,189207,8535209,38.0,6.2
Tender_6313,1158181,4131367,1016906,107413,129693,6543560,41.33,5.87
Tender_6314,3509426,3759376,2132982,143091,366364,9911239,51.33,4.87
Tender_6315,5754418,836411,2970689,300253,193712,10055483,34.67,6.53
Tender_6316,2950518,4006921,242599,563235,423580,8186853,30.0,7.0
Tender_6317,6311843,1015373,867791,367292,474627,9036926,28.33,7.17
Tender_6318,1405226,1944554,2268377,243705,465350,6327212,46.67,5.33
Tender_6319,2791778,2993195,2051604,428569,462105,8727251,39.0,6.1
Tender_6320,215663,4835032,638339,611366,338614,6639014,37.33,6.27
Tender_6321,9100483,2797997,1689442,573747,463191,14624860,39.33,6.07
Tender_6322,7812652,666045,611365,133370,474724,9698156,40.33,5.97
Tender_6323,6211618,4357561,569395,153600,337610,11629784,31.67,6.83
Tender_6324,5914772,2446764,2004802,482478,489889,11338705,25.33,7.47
Tender_6325,5438016,3561207,2164968,970695,66802,12201688,23.0,7.7
Tender_6326,6914423,4968140,2232219,570748,249014,14934544,54.33,4.57
Tender_6327,8564984,965475,752039,149524,197147,10629169,41.0,5.9
Tender_6328,1144652,4070303,2586429,370127,384051,8555562,41.0,5.9
Tender_6329,375889,1357477,916498,795091,450368,3895323,44.33,5.57
Tender_6330,5001644,4366327,2874149,186380,447732,12876232,39.33,6.07
Tender_6331,8163057,2627212,363588,228151,404459,11786467,29.67,7.03
Tender_6332,6135719,4068102,1179820,809078,455512,12648231,32.67,6.73
Tender_6333,9388081,817101,1344186,519734,74322,12143424,39.33,6.07
Tender_6334,7910204,1307222,2396959,434482,256035,12304902,43.67,5.63
Tender_6335,926937,3892651,1935990,363964,322234,7441776,35.0,6.5
Tender_6336,1863419,1036220,2965295,150960,450671,6466565,47.67,5.23
Tender_6337,2427577,1373355,2590960,102430,221914,6716236,29.33,7.07
Tender_6338,8904346,4203168,1357446,664120,336599,15465679,21.67,7.83
Tender_6339,524193,1535001,2012181,383006,54873,4509254,38.33,6.17
Tender_6340,9625389,2650394,1687743,907154,397329,15268009,35.33,6.47
Tender_6341,7898015,820818,2566835,696262,380650,12362580,35.0,6.5
Tender_6342,745610,4628245,2814217,523599,250947,8962618,50.67,4.93
Tender_6343,3414803,4182276,1055746,378556,479522,9510903,23.67,7.63
Tender_6344,4801547,4615384,640169,479483,413304,10949887,15.33,8.47
Tender_6345,1873462,1787180,1434197,578404,362515,6035758,36.67,6.33
Tender_6346,2220039,2107234,2020542,400816,344802,7093433,41.0,5.9
Tender_6347,6774779,2062158,814397,799121,447332,10897787,23.33,7.67
Tender_6348,3490919,1871114,1638003,361761,190207,7552004,48.33,5.17
Tender_6349,9239885,564446,255779,203392,173930,10437432,39.0,6.1
Tender_6350,7226518,3651998,1237254,75663,207169,12398602,40.0,6.0
Tender_6351,1439878,3153443,1242880,479114,384811,6700126,47.0,5.3
Tender_6352,790399,2998527,2609349,444302,357958,7200535,47.0,5.3
Tender_6353,1727606,3878426,178058,513634,239923,6537647,24.33,7.57
Tender_6354,349168,3430695,2669698,163620,365849,6979030,35.67,6.43
Tender_6355,9090197,682654,617833,240425,498015,11129124,26.0,7.4
Tender_6356,3556290,2129456,1524734,331286,303440,7845206,40.0,6.0
Tender_6357,1100063,3084773,2877170,694290,362418,8118714,29.67,7.03
Tender_6358,1933373,2975858,677504,333898,235935,6156568,39.0,6.1
Tender_6359,6432395,1198838,2773449,330298,320765,11055745,40.67,5.93
Tender_6360,3453327,1264949,581298,295727,453071,6048372,37.67,6.23
Tender_6361,5956698,138174,2264307,368930,137488,8865597,39.33,6.07
Tender_6362,2515597,1391193,220785,583454,403595,5114624,32.0,6.8
Tender_6363,7731985,1182419,1011300,883891,490235,11299830,45.67,5.43
Tender_6364,9537185,3821539,2506038,388278,176106,16429146,35.67,6.43
Tender_6365,567561,3742432,196346,951426,128749,5586514,25.67,7.43
Tender_6366,959819,933022,2430847,327147,482194,5133029,35.0,6.5
Tender_6367,5683313,4209730,2403623,204291,206196,12707153,43.0,5.7
Tender_6368,7054371,3933475,2372894,78699,296483,13735922,53.67,4.63
Tender_6369,828267,331380,55403,800467,86113,2101630,42.33,5.77
Tender_6370,8736393,384535,701870,858580,98539,10779917,29.67,7.03
Tender_6371,9138545,832822,1484781,829181,192575,12477904,54.67,4.53
Tender_6372,7042490,1544152,2757202,642747,278914,12265505,50.67,4.93
Tender_6373,3433172,4578726,1036490,626604,115919,9790911,45.33,5.47
Tender_6374,9558609,484818,1590162,709496,380788,12723873,23.67,7.63
Tender_6375,5040167,4722538,653491,745040,482168,11643404,49.0,5.1
Tender_6376,1635475,2988797,1095451,496359,486409,6702491,34.0,6.6
Tender_6377,6652198,2971415,1342502,981664,284340,12232119,46.67,5.33
Tender_6378,2553629,669405,2369111,67693,298784,5958622,34.33,6.57
Tender_6379,9334658,3898549,1245806,901641,125715,15506369,38.67,6.13
Tender_6380,5431341,1624924,1906185,649401,485593,10097444,43.67,5.63
Tender_6381,1977108,2372136,2860820,562513,50407,7822984,42.67,5.73
Tender_6382,4588337,4680641,462839,578961,336235,10647013,37.0,6.3
Tender_6383,4609943,4692243,664677,319612,403278,10689753,46.0,5.4
Tender_6384,7557800,4716388,1143595,782548,76589,14276920,50.33,4.97
Tender_6385,4924136,2173125,1315789,760717,290094,9463861,51.0,4.9
Tender_6386,6727356,1959500,2487252,582960,389754,12146822,59.33,4.07
Tender_6387,686212,1066172,2077096,251944,360043,4441467,37.33,6.27
Tender_6388,6234920,870224,2075946,600217,473930,10255237,23.33,7.67
Tender_6389,8514387,4826214,2312651,641846,205929,16501027,28.33,7.17
Tender_6390,9919440,4383828,2134937,254820,336703,17029728,23.67,7.63
Tender_6391,2990611,4898180,2683765,652389,468221,11693166,40.0,6.0
Tender_6392,4371748,3729482,790401,243867,153292,9288790,45.0,5.5
Tender_6393,3018753,4719652,1864556,773790,217454,10594205,39.67,6.03
Tender_6394,1257707,2162648,2201490,368478,243725,6234048,32.33,6.77
Tender_6395,9299256,3140735,1552115,214415,151370,14357891,37.67,6.23
Tender_6396,3517899,2636055,1773181,742250,336433,9005818,33.67,6.63
Tender_6397,9785025,382692,1376439,736938,91163,12372257,50.33,4.97
Tender_6398,5611776,3189876,1580780,874576,57694,11314702,53.67,4.63
Tender_6399,8267705,1260194,109984,590365,257101,10485349,49.0,5.1
Tender_6400,7167996,2818806,1555673,121035,276205,11939715,37.33,6.27
Tender_6401,9244083,3426996,2937735,141291,257673,16007778,28.33,7.17
Tender_6402,5975792,2231321,610152,192218,95242,9104725,39.0,6.1
Tender_6403,3495031,275753,2225368,736329,142984,6875465,24.67,7.53
Tender_6404,9072917,3340450,1223187,246619,340455,14223628,33.33,6.67
Tender_6405,4091542,301863,1044233,708022,464628,6610288,46.0,5.4
Tender_6406,3381484,2965252,90893,486765,104835,7029229,40.67,5.93
Tender_6407,5689722,3424951,1306861,215903,249023,10886460,47.33,5.27
Tender_6408,6494264,2677492,1287621,661507,194687,11315571,40.67,5.93
Tender_6409,2314554,1847011,1073428,988431,114097,6337521,43.0,5.7
Tender_6410,4685173,1249531,2786762,802591,166276,9690333,39.33,6.07
Tender_6411,2088298,190615,1316211,277286,146432,4018842,37.33,6.27
Tender_6412,6019164,513794,679470,622055,414256,8248739,60.0,4.0
Tender_6413,1587940,4384703,1204678,910132,64249,8151702,36.67,6.33
Tender_6414,8016075,4709647,1805825,984034,347671,15863252,62.0,3.8
Tender_6415,9510593,2925649,1162424,209265,415184,14223115,40.67,5.93
Tender_6416,6939218,185852,1559256,580902,406996,9672224,43.33,5.67
Tender_6417,4138444,4927268,716599,606520,475120,10863951,27.33,7.27
Tender_6418,1863788,679951,711817,525364,258034,4038954,58.33,4.17
Tender_6419,9325156,2902642,215640,518688,157200,13119326,46.33,5.37
Tender_6420,9971603,4290142,1005459,561876,381862,16210942,32.67,6.73
Tender_6421,3212414,1598027,2618560,616502,458112,8503615,36.67,6.33
Tender_6422,7966085,4286080,1259125,814952,217776,14544018,46.33,5.37
Tender_6423,8896221,2835277,2401617,914639,334962,15382716,40.0,6.0
Tender_6424,6575566,126296,225967,910051,478541,8316421,39.0,6.1
Tender_6425,9583667,3713293,1530755,570290,410691,15808696,29.33,7.07
Tender_6426,6339004,2176143,1093758,261730,450021,10320656,28.67,7.13
Tender_6427,7118725,3564530,1084986,180001,289193,12237435,41.0,5.9
Tender_6428,8799140,1527984,479736,286446,452025,11545331,48.0,5.2
Tender_6429,8066212,1379165,2781193,380562,351303,12958435,33.67,6.63
Tender_6430,9743550,4602432,2295337,972544,129990,17743853,31.33,6.87
Tender_6431,6648286,1580100,1620039,64040,486480,10398945,43.67,5.63
Tender_6432,7822007,1456083,1284498,291725,88520,10942833,38.33,6.17
Tender_6433,3594479,2857057,1068252,414550,124775,8059113,40.0,6.0
Tender_6434,8004038,202055,2107525,550223,373821,11237662,38.0,6.2
Tender_6435,6281347,2999602,2297811,320493,222386,12121639,30.33,6.97
Tender_6436,6625972,2149435,826707,309614,372223,10283951,35.67,6.43
Tender_6437,9166422,4369893,2726958,305768,95887,16664928,24.33,7.57
Tender_6438,8934879,3380923,1831971,656279,272958,15077010,54.67,4.53
Tender_6439,746711,2782826,2732445,783509,57330,7102821,37.67,6.23
Tender_6440,8887308,1698541,768091,409051,488372,12251363,31.33,6.87
Tender_6441,5608304,883426,1393535,976187,172763,9034215,58.67,4.13
Tender_6442,7046138,1184544,2772785,988314,488090,12479871,46.67,5.33
Tender_6443,7522750,1742340,2417840,78112,347967,12109009,38.33,6.17
Tender_6444,6053124,2751819,1309791,910777,362141,11387652,44.67,5.53
Tender_6445,2599979,4793324,1486793,731349,337552,9948997,50.67,4.93
Tender_6446,2187310,2329217,2282648,249262,476733,7525170,40.33,5.97
Tender_6447,6590203,4453311,2849685,966063,361642,15220904,38.67,6.13
Tender_6448,3862840,2327596,844658,664416,398959,8098469,42.0,5.8
Tender_6449,5302190,1390476,2308102,512799,335089,9848656,27.0,7.3
Tender_6450,9019892,611702,2677795,604837,361914,13276140,43.33,5.67
Tender_6451,8185768,4895653,2757858,932338,496788,17268405,43.67,5.63
Tender_6452,9469245,2321762,1448234,585501,64316,13889058,37.67,6.23
Tender_6453,6552040,882819,829173,475220,240351,8979603,42.0,5.8
Tender_6454,4712182,4492459,422411,287496,387131,10301679,36.33,6.37
Tender_6455,8946798,2386552,1290687,52077,136850,12812964,41.0,5.9
Tender_6456,599442,2578887,2582597,324554,102966,6188446,34.67,6.53
Tender_6457,2296684,2416470,1517082,968143,227175,7425554,37.67,6.23
Tender_6458,1062871,3718191,1965816,78662,120008,6945548,53.33,4.67
Tender_6459,5732932,1412775,2969550,534958,245031,10895246,57.33,4.27
Tender_6460,2151558,470781,2870406,354410,429083,6276238,38.67,6.13
Tender_6461,1757052,2345887,2663689,159682,298892,7225202,46.67,5.33
Tender_6462,8683616,1671731,1450551,673184,499247,12978329,32.67,6.73
Tender_6463,4973861,2681375,2050479,577913,205451,10489079,28.0,7.2
Tender_6464,2527350,2927291,1698737,574959,108835,7837172,32.33,6.77
Tender_6465,6493951,4290332,2119323,579582,370838,13854026,41.0,5.9
Tender_6466,5307182,4028511,1723784,599734,145794,11805005,44.33,5.57
Tender_6467,2274797,1666410,151979,979761,128900,5201847,42.0,5.8
Tender_6468,280591,3857555,775166,465734,461148,5840194,42.33,5.77
Tender_6469,2833416,1712099,1238421,473969,454207,6712112,49.33,5.07
Tender_6470,2656506,832815,1231160,300315,353725,5374521,40.33,5.97
Tender_6471,1047194,2131957,261443,155862,92840,3689296,35.0,6.5
Tender_6472,6335681,1463121,370036,947356,214501,9330695,44.33,5.57
Tender_6473,9166992,837936,499580,806766,152869,11464143,49.33,5.07
Tender_6474,4214860,1003141,1260738,603952,466752,7549443,40.0,6.0
Tender_6475,5603561,4375517,863639,264091,189934,11296742,31.33,6.87
Tender_6476,9899456,381565,801395,460496,377702,11920614,26.33,7.37
Tender_6477,5620577,4378253,252324,548413,277438,11077005,44.33,5.57
Tender_6478,8194582,1439592,1382010,356393,94520,11467097,53.0,4.7
Tender_6479,9474928,1962387,1187194,480080,371892,13476481,48.67,5.13
Tender_6480,8978395,4652536,2256128,754897,95749,16737705,51.67,4.83
Tender_6481,559745,402715,2204939,261424,361433,3790256,49.0,5.1
Tender_6482,9140614,3940426,69669,304263,466563,13921535,37.0,6.3
Tender_6483,3947375,2406643,988405,753483,331386,8427292,51.67,4.83
Tender_6484,6011916,1898495,2051091,886015,490354,11337871,26.33,7.37
Tender_6485,2449291,4535947,738424,764040,285434,8773136,42.0,5.8
Tender_6486,6514951,2980127,491035,104333,326118,10416564,30.67,6.93
Tender_6487,3103397,3945202,2114212,308446,289619,9760876,30.67,6.93
Tender_6488,7708800,1543671,2376669,357153,222528,12208821,26.33,7.37
Tender_6489,4298682,478476,2236049,966187,342807,8322201,27.33,7.27
Tender_6490,9241042,2052197,1888614,672497,119406,13973756,28.33,7.17
Tender_6491,3223601,1239712,2393008,333979,470872,7661172,30.0,7.0
Tender_6492,7613724,804763,1354791,456184,283828,10513290,44.0,5.6
Tender_6493,6851289,3705632,1296278,535351,151823,12540373,43.67,5.63
Tender_6494,472317,2903829,373092,857906,225441,4832585,38.67,6.13
Tender_6495,7520190,1126326,1521997,888317,410300,11467130,37.67,6.23
Tender_6496,7848272,2762325,250289,93331,265971,11220188,21.33,7.87
Tender_6497,804352,3171307,1585489,188754,143914,5893816,45.0,5.5
Tender_6498,6876475,3681735,1734267,890192,157315,13339984,43.0,5.7
Tender_6499,2636617,3920153,2389384,953554,140930,10040638,41.33,5.87
Tender_6500,6343154,2087543,629561,740315,253551,10054124,28.33,7.17
Tender_6501,274757,1691466,2385188,562025,108638,5022074,36.0,6.4
Tender_6502,1550832,3781363,1690174,446240,66856,7535465,35.67,6.43
Tender_6503,8108446,3253388,267495,633131,55132,12317592,34.33,6.57
Tender_6504,3014446,711993,2044285,60134,145255,5976113,54.67,4.53
Tender_6505,6967680,506684,1104354,720413,295782,9594913,48.33,5.17
Tender_6506,1850990,3913073,2289787,485537,496217,9035604,32.67,6.73
Tender_6507,1779689,1256577,1442199,541834,66849,5087148,51.0,4.9
Tender_6508,9238052,3785464,835779,86014,155307,14100616,45.67,5.43
Tender_6509,1225859,4024404,2427282,325852,113666,8117063,43.67,5.63
Tender_6510,5667903,4773062,2188590,636450,412216,13678221,25.33,7.47
Tender_6511,7535610,4166054,1625478,100456,209999,13637597,43.0,5.7
Tender_6512,1208053,3604997,1981706,255622,445721,7496099,56.33,4.37
Tender_6513,6512904,2866344,1589644,611004,207527,11787423,44.33,5.57
Tender_6514,9813182,4200482,1449446,267648,442995,16173753,39.0,6.1
Tender_6515,4184595,2071671,1247087,355703,132660,7991716,36.67,6.33
Tender_6516,3231584,1372863,641456,915373,230498,6391774,46.33,5.37
Tender_6517,4311912,2539310,716763,801131,450176,8819292,34.67,6.53
Tender_6518,2523434,3620290,2943080,248275,420392,9755471,38.33,6.17
Tender_6519,3455726,325536,2321443,857411,107633,7067749,26.33,7.37
Tender_6520,7435162,3186781,1059143,832937,79700,12593723,43.67,5.63
Tender_6521,8425282,4097474,2427185,64248,437580,15451769,28.33,7.17
Tender_6522,4230036,398474,765493,505126,107401,6006530,39.33,6.07
Tender_6523,6907156,3031798,1347686,699154,403788,12389582,43.67,5.63
Tender_6524,5906091,245877,2097024,987293,95779,9332064,22.33,7.77
Tender_6525,4487931,1240474,824515,81792,73246,6707958,33.67,6.63
Tender_6526,1000499,858602,2725060,871260,476580,5932001,36.33,6.37
Tender_6527,1574981,897802,2700779,309657,365282,5848501,31.0,6.9
Tender_6528,9642188,1247327,2930230,382086,446244,14648075,36.67,6.33
Tender_6529,8196197,2876435,137569,825804,54922,12090927,40.0,6.0
Tender_6530,3790829,188097,2941675,422117,454688,7797406,37.0,6.3
Tender_6531,2201883,3202577,2283217,446303,51592,8185572,31.33,6.87
Tender_6532,1369887,4387029,432928,330047,241254,6761145,36.67,6.33
Tender_6533,1706106,1934537,2010844,804060,158433,6613980,34.33,6.57
Tender_6534,3054528,3425022,714535,130686,377968,7702739,50.33,4.97
Tender_6535,578900,4474051,2129971,454833,280498,7918253,46.0,5.4
Tender_6536,2577653,1514688,1588167,522019,75492,6278019,41.67,5.83
Tender_6537,7987711,2861772,2851410,244268,471093,14416254,39.0,6.1
Tender_6538,3037782,645286,1515594,103768,396078,5698508,48.0,5.2
Tender_6539,3183896,3946535,618514,702238,442060,8893243,42.33,5.77
Tender_6540,2105024,504291,1622575,58208,346057,4636155,22.33,7.77
Tender_6541,6816183,1343326,2172885,504886,317093,11154373,23.33,7.67
Tender_6542,4261313,2446051,2411551,640719,400313,10159947,48.67,5.13
Tender_6543,1328175,3063337,984366,174909,250079,5800866,18.67,8.13
Tender_6544,8395860,3205449,2528616,204970,404139,14739034,43.33,5.67
Tender_6545,5155417,1337329,1352004,228158,394650,8467558,42.0,5.8
Tender_6546,1803001,3248396,773642,157925,112869,6095833,35.0,6.5
Tender_6547,3936013,3908644,1491133,637335,452299,10425424,42.67,5.73
Tender_6548,9389199,2244765,2444000,693385,301199,15072548,50.67,4.93
Tender_6549,9741069,3751407,1669366,600337,117271,15879450,47.67,5.23
Tender_6550,2351057,4861454,816940,70203,426321,8525975,34.67,6.53
Tender_6551,7753487,2081925,1011759,273320,365972,11486463,55.0,4.5
Tender_6552,4269524,2494684,1924794,743468,143835,9576305,30.0,7.0
Tender_6553,3956916,2647937,1279378,201047,455957,8541235,39.33,6.07
Tender_6554,4883582,1690997,481360,507482,335612,7899033,48.0,5.2
Tender_6555,464015,1596521,2935763,278103,320361,5594763,36.67,6.33
Tender_6556,5828566,1204405,405602,116763,162130,7717466,39.67,6.03
Tender_6557,9243689,1454372,2878532,65235,122303,13764131,39.33,6.07
Tender_6558,6827455,4720534,488925,138440,118695,12294049,35.33,6.47
Tender_6559,4300521,1710286,808078,940111,392449,8151445,44.33,5.57
Tender_6560,5572329,3836307,505740,985584,353669,11253629,48.67,5.13
Tender_6561,5076077,1531472,1087378,882828,327593,8905348,41.0,5.9
Tender_6562,7524016,723212,2427079,311240,180940,11166487,50.33,4.97
Tender_6563,3306974,1747783,1384892,893610,447656,7780915,55.67,4.43
Tender_6564,4387564,167047,540825,583884,306132,5985452,41.0,5.9
Tender_6565,2537973,1653377,506825,635704,205044,5538923,40.0,6.0
Tender_6566,6631513,4249121,1729732,101542,270339,12982247,40.0,6.0
Tender_6567,7403783,1861965,2037622,637690,90664,12031724,43.33,5.67
Tender_6568,2533461,1664564,895419,765763,140166,5999373,34.67,6.53
Tender_6569,4524791,1153084,1903936,478081,138958,8198850,29.0,7.1
Tender_6570,2754274,356093,1146786,218656,62786,4538595,41.33,5.87
Tender_6571,9955628,2625414,2844665,681705,291892,16399304,50.33,4.97
Tender_6572,7324975,2641063,2583944,722529,78010,13350521,39.33,6.07
Tender_6573,6515764,4691126,2130174,833133,287299,14457496,44.33,5.57
Tender_6574,3940711,2520609,1857761,777024,157372,9253477,46.33,5.37
Tender_6575,488198,178522,789768,445421,88147,1990056,42.67,5.73
Tender_6576,7723348,308283,2688163,716248,376357,11812399,26.33,7.37
Tender_6577,4851036,201117,2770755,479025,306174,8608107,27.0,7.3
Tender_6578,2407820,2393441,767802,229833,83863,5882759,31.0,6.9
Tender_6579,6662701,3080374,237469,685904,300665,10967113,37.0,6.3
Tender_6580,7298959,1918511,784547,205938,219651,10427606,43.33,5.67
Tender_6581,3617003,2616207,447986,253862,419684,7354742,29.0,7.1
Tender_6582,3737639,2522875,1442750,172929,294424,8170617,31.67,6.83
Tender_6583,8618573,2401304,1177262,649019,258062,13104220,44.67,5.53
Tender_6584,1611490,3398565,1331921,159813,145810,6647599,26.0,7.4
Tender_6585,3125891,1651812,591347,720093,319874,6409017,36.0,6.4
Tender_6586,2685046,1519518,1066005,222159,163115,5655843,25.33,7.47
Tender_6587,9054017,4294252,2278459,237006,280294,16144028,36.67,6.33
Tender_6588,653098,1218255,2614363,471117,366706,5323539,39.67,6.03
Tender_6589,355957,4296480,2598760,490712,248308,7990217,28.33,7.17
Tender_6590,3307624,698107,1032582,513388,309572,5861273,33.67,6.63
Tender_6591,3933070,4239814,2742628,420515,239069,11575096,26.67,7.33
Tender_6592,8125880,1387874,1169945,441964,249930,11375593,43.67,5.63
Tender_6593,1124891,4161181,2913699,410747,259632,8870150,45.33,5.47
Tender_6594,7080007,1577938,1913542,282561,165549,11019597,58.33,4.17
Tender_6595,558127,2415641,1441081,617611,417679,5450139,42.0,5.8
Tender_6596,3479801,2132705,2312520,254562,288280,8467868,35.0,6.5
Tender_6597,1396646,1755886,1187130,545208,257010,5141880,39.0,6.1
Tender_6598,4995281,2301039,913997,736410,173589,9120316,49.67,5.03
Tender_6599,1313314,4023041,2003026,267779,435143,8042303,33.0,6.7
Tender_6600,7888360,3859528,1222079,828889,499554,14298410,51.67,4.83
Tender_6601,4314974,1504002,64003,989883,286461,7159323,36.0,6.4
Tender_6602,4376063,277002,576139,387022,154770,5770996,44.0,5.6
Tender_6603,6735759,2328102,2739468,549799,459430,12812558,30.0,7.0
Tender_6604,2088320,4565838,2095692,675715,152138,9577703,37.67,6.23
Tender_6605,2884740,2309744,2795114,845034,470799,9305431,53.33,4.67
Tender_6606,4129696,2506095,2333153,815547,496290,10280781,26.67,7.33
Tender_6607,3850071,2110300,119029,790624,225354,7095378,41.67,5.83
Tender_6608,3586344,4201958,1642590,697682,183106,10311680,38.0,6.2
Tender_6609,9384079,3317034,2718880,582378,293755,16296126,35.67,6.43
Tender_6610,1725632,1322546,581185,567483,124174,4321020,33.67,6.63
Tender_6611,9393665,4735530,139335,754686,449987,15473203,59.33,4.07
Tender_6612,4510434,1361917,2568934,967069,435754,9844108,30.33,6.97
Tender_6613,5959733,2922562,641948,807378,196015,10527636,37.33,6.27
Tender_6614,4892323,3183456,738801,298374,66032,9178986,39.33,6.07
Tender_6615,9982902,4892181,1898061,363620,84718,17221482,44.67,5.53
Tender_6616,7610823,2678139,1462376,970083,325913,13047334,35.0,6.5
Tender_6617,6093410,4775914,472638,896632,364102,12602696,37.67,6.23
Tender_6618,1562306,2518017,1568804,467786,84903,6201816,36.0,6.4
Tender_6619,5847113,4788221,2384115,609246,239199,13867894,55.67,4.43
Tender_6620,2846893,1465367,2664049,792965,376880,8146154,57.67,4.23
Tender_6621,4246791,4262292,1466797,702919,422335,11101134,39.67,6.03
Tender_6622,9092402,3030571,2766179,970446,374122,16233720,47.33,5.27
Tender_6623,5926580,4943225,1555838,936932,102164,13464739,31.33,6.87
Tender_6624,9609240,3347362,677671,871081,54517,14559871,52.0,4.8
Tender_6625,9845826,3157679,966409,914152,342055,15226121,42.33,5.77
Tender_6626,7571765,3190357,275261,300506,409866,11747755,41.0,5.9
Tender_6627,2732881,4724585,1135391,694213,226686,9513756,39.33,6.07
Tender_6628,6039474,4230143,1531016,152461,267975,12221069,38.0,6.2
Tender_6629,553250,3737546,2883740,628785,441267,8244588,40.67,5.93
Tender_6630,6618118,4948338,2798745,862951,442726,15670878,32.33,6.77
Tender_6631,7867353,2199434,508057,939006,383109,11896959,40.0,6.0
Tender_6632,1471242,992218,2966930,408178,330293,6168861,46.67,5.33
Tender_6633,3968978,2095249,1105394,985937,456566,8612124,31.0,6.9
Tender_6634,2577572,306826,726757,865959,320370,4797484,31.33,6.87
Tender_6635,2431264,125940,1307107,194545,250027,4308883,48.33,5.17
Tender_6636,3893507,4348292,1748650,169284,109360,10269093,30.0,7.0
Tender_6637,7757381,3779871,2449412,986938,222842,15196444,21.33,7.87
Tender_6638,470174,882404,1877606,863630,487929,4581743,41.67,5.83
Tender_6639,9920109,545345,926474,777503,244234,12413665,40.0,6.0
Tender_6640,470988,3639162,2061710,317614,243666,6733140,35.67,6.43
Tender_6641,4196629,1331435,453095,964912,467622,7413693,60.67,3.93
Tender_6642,1954976,1943573,205995,527008,151338,4782890,41.33,5.87
Tender_6643,4223544,2916707,2481517,643563,215679,10481010,45.67,5.43
Tender_6644,5384929,1019048,2504407,874671,89653,9872708,36.33,6.37
Tender_6645,6768444,3407340,2607695,379285,442238,13605002,53.33,4.67
Tender_6646,5439650,4829072,1730209,686105,174371,12859407,17.67,8.23
Tender_6647,5092252,1886675,1192156,655953,219622,9046658,37.67,6.23
Tender_6648,4015758,1006691,426921,257021,404481,6110872,34.67,6.53
Tender_6649,367536,4335410,753438,623680,432782,6512846,52.0,4.8
Tender_6650,1602111,1642138,1126647,490484,349304,5210684,38.0,6.2
Tender_6651,5720205,2313787,2510434,667183,135923,11347532,39.67,6.03
Tender_6652,4005920,2420006,1581568,272392,81235,8361121,53.67,4.63
Tender_6653,3917243,3343925,1679831,631305,291233,9863537,20.33,7.97
Tender_6654,9898775,2510942,2310013,265998,257789,15243517,43.33,5.67
Tender_6655,5827692,4970247,2300892,930707,267226,14296764,45.67,5.43
Tender_6656,9603705,2803015,2926473,758633,305393,16397219,23.0,7.7
Tender_6657,3965677,3449420,360019,87514,361371,8224001,46.67,5.33
Tender_6658,3371830,3316257,2549348,858304,322783,10418522,31.33,6.87
Tender_6659,2441466,2901388,316272,306513,413554,6379193,47.33,5.27
Tender_6660,7306717,3471943,565815,986061,323507,12654043,46.33,5.37
Tender_6661,6253489,3578290,497563,892321,377317,11598980,25.67,7.43
Tender_6662,856608,194401,639243,633002,360269,2683523,36.0,6.4
Tender_6663,419007,1643843,2483476,436856,263793,5246975,29.0,7.1
Tender_6664,2181654,335455,374478,824827,316335,4032749,38.67,6.13
Tender_6665,3126493,4244487,2528916,906487,184412,10990795,40.67,5.93
Tender_6666,9055264,3677389,1936313,323738,119672,15112376,34.33,6.57
Tender_6667,1384153,1287584,1167615,526884,474784,4841020,27.0,7.3
Tender_6668,8677413,2446320,658935,812232,309084,12903984,35.0,6.5
Tender_6669,5373037,2722403,1846118,212096,222352,10376006,44.33,5.57
Tender_6670,9146886,766965,2635449,592425,442367,13584092,43.0,5.7
Tender_6671,3924265,2094270,1184340,652492,342660,8198027,35.0,6.5
Tender_6672,6701110,600196,533081,924567,463087,9222041,39.67,6.03
Tender_6673,5227435,4979785,346921,442623,203443,11200207,23.67,7.63
Tender_6674,5795284,3523882,421860,694816,404186,10840028,28.33,7.17
Tender_6675,1246228,1038393,1946043,747476,380924,5359064,47.33,5.27
Tender_6676,4341833,1280930,2933334,314071,253499,9123667,33.0,6.7
Tender_6677,1075658,3961652,621659,870740,456910,6986619,44.33,5.57
Tender_6678,1160282,1993646,921754,194986,255826,4526494,36.33,6.37
Tender_6679,6700353,2554286,1114916,173604,382615,10925774,33.33,6.67
Tender_6680,8013952,4476683,2797485,180257,116850,15585227,40.67,5.93
Tender_6681,9852537,2896208,1825645,895877,153346,15623613,32.33,6.77
Tender_6682,1340066,4132966,1690035,333557,209295,7705919,39.33,6.07
Tender_6683,3604269,2694328,117957,820779,189679,7427012,23.33,7.67
Tender_6684,4964947,2603697,1028222,410353,363853,9371072,47.0,5.3
Tender_6685,7050943,727020,2234204,837191,256947,11106305,34.67,6.53
Tender_6686,9577483,4770443,75385,589022,471585,15483918,50.33,4.97
Tender_6687,861893,2523560,2432605,412807,145535,6376400,49.0,5.1
Tender_6688,6603243,2601946,170590,445806,119913,9941498,36.67,6.33
Tender_6689,661964,1491128,563134,175921,291268,3183415,22.0,7.8
Tender_6690,6641316,3755303,1034323,641238,335489,12407669,35.0,6.5
Tender_6691,6018042,2787125,470546,558095,296968,10130776,43.33,5.67
Tender_6692,6835648,2426019,2125268,970852,253159,12610946,34.33,6.57
Tender_6693,1283454,4976276,493776,585412,93039,7431957,25.0,7.5
Tender_6694,2628250,2781658,2240450,77854,455029,8183241,24.67,7.53
Tender_6695,2082617,1969730,2056532,908712,322995,7340586,54.33,4.57
Tender_6696,8470370,3790774,427033,358000,416173,13462350,32.67,6.73
Tender_6697,5418570,437041,2275942,974101,302294,9407948,42.0,5.8
Tender_6698,8117866,3188253,283716,943118,53651,12586604,50.33,4.97
Tender_6699,2527093,4053355,1018981,899635,233951,8733015,50.33,4.97
Tender_6700,7122319,3047919,1794753,982521,300165,13247677,37.33,6.27
Tender_6701,8337105,2379428,925221,635913,65812,12343479,40.67,5.93
Tender_6702,3217611,2582150,361756,830986,325132,7317635,40.0,6.0
Tender_6703,3753518,790715,992543,153450,112950,5803176,46.0,5.4
Tender_6704,5296352,2872958,1160374,874351,81949,10285984,30.0,7.0
Tender_6705,848485,4397018,1934140,576916,353756,8110315,40.33,5.97
Tender_6706,7482798,3971916,2594377,667765,89404,14806260,27.0,7.3
Tender_6707,9250250,2676440,691072,722307,158803,13498872,56.67,4.33
Tender_6708,9368239,2377181,495860,828019,208870,13278169,29.67,7.03
Tender_6709,7578480,1125109,2450043,917034,463831,12534497,41.33,5.87
Tender_6710,8524080,2960577,230433,883424,154396,12752910,20.67,7.93
Tender_6711,2702061,198977,976664,847112,473558,5198372,46.33,5.37
Tender_6712,8276624,1552196,659262,60767,209064,10757913,30.0,7.0
Tender_6713,5878179,1279663,2217208,213190,125035,9713275,44.0,5.6
Tender_6714,3529514,1416356,2898549,668644,356682,8869745,44.67,5.53
Tender_6715,9394904,2862111,2117230,90992,269468,14734705,35.33,6.47
Tender_6716,7207553,664080,2701245,151395,270126,10994399,52.67,4.73
Tender_6717,6734276,4668664,524470,601468,212281,12741159,37.33,6.27
Tender_6718,9417223,3227996,2068028,838955,161049,15713251,38.33,6.17
Tender_6719,8357341,4815753,386534,968360,99380,14627368,28.67,7.13
Tender_6720,1128091,3779158,2197645,134234,130423,7369551,35.33,6.47
Tender_6721,7660381,3253923,1361433,608884,111303,12995924,34.33,6.57
Tender_6722,3692184,4419249,1682090,138089,313812,10245424,38.0,6.2
Tender_6723,5225732,815895,189598,945510,385364,7562099,29.67,7.03
Tender_6724,2299471,727289,1643615,316709,335092,5322176,46.67,5.33
Tender_6725,1914849,3287891,2026034,87470,219795,7536039,17.67,8.23
Tender_6726,9216266,2746805,532586,530941,108883,13135481,45.0,5.5
Tender_6727,472179,3049488,1201312,728634,326419,5778032,34.67,6.53
Tender_6728,8762873,146078,2282853,192893,129776,11514473,31.33,6.87
Tender_6729,3626595,4478807,2722790,645301,95575,11569068,49.0,5.1
Tender_6730,2022928,1047703,2665676,331567,438470,6506344,42.33,5.77
Tender_6731,6867386,2701005,2248969,629955,394219,12841534,60.0,4.0
Tender_6732,8673913,616150,330133,609930,261727,10491853,39.33,6.07
Tender_6733,2461315,4497456,1580027,977440,188684,9704922,27.0,7.3
Tender_6734,3546071,3801213,1026219,264999,451829,9090331,34.0,6.6
Tender_6735,8561772,3640204,820367,119319,127042,13268704,41.0,5.9
Tender_6736,9871650,4833336,183449,599726,75543,15563704,33.67,6.63
Tender_6737,6436331,1085539,2988839,117752,483389,11111850,44.67,5.53
Tender_6738,4300200,3213628,477687,54420,55916,8101851,41.0,5.9
Tender_6739,5257007,4001981,173666,87757,76930,9597341,30.33,6.97
Tender_6740,2444516,2437910,2985150,978541,367093,9213210,46.33,5.37
Tender_6741,689923,4750821,2016130,937490,50913,8445277,33.67,6.63
Tender_6742,5727500,350687,2898570,562675,358351,9897783,53.0,4.7
Tender_6743,7091675,602379,1012020,754008,332536,9792618,45.33,5.47
Tender_6744,7014472,2634909,2877504,76411,283818,12887114,34.0,6.6
Tender_6745,8630989,4331614,1571075,972316,402297,15908291,50.33,4.97
Tender_6746,585553,3672168,1545390,885699,403223,7092033,34.67,6.53
Tender_6747,7857547,4938955,2206558,427664,332447,15763171,32.0,6.8
Tender_6748,3961550,467972,869241,768198,249521,6316482,27.33,7.27
Tender_6749,6213421,4504879,373219,969869,467349,12528737,40.33,5.97
Tender_6750,3083241,210867,151802,897736,364286,4707932,42.0,5.8
Tender_6751,6843727,1401376,1880492,563094,281253,10969942,51.67,4.83
Tender_6752,7757386,3261526,679781,309594,132993,12141280,35.33,6.47
Tender_6753,5521325,4276149,406488,569489,331799,11105250,29.67,7.03
Tender_6754,6718089,4413924,724887,553374,469397,12879671,48.0,5.2
Tender_6755,6114779,1308596,2201321,311597,52056,9988349,39.33,6.07
Tender_6756,3160560,1449676,2153750,913451,369951,8047388,40.67,5.93
Tender_6757,9244678,2238757,2548154,261106,361372,14654067,52.67,4.73
Tender_6758,325921,4908005,2840160,650170,243157,8967413,35.33,6.47
Tender_6759,6478617,230677,521805,844348,286594,8362041,25.0,7.5
Tender_6760,4274229,2092178,1781186,737086,326864,9211543,47.67,5.23
Tender_6761,843272,2702143,2529510,576838,408945,7060708,32.67,6.73
Tender_6762,3463815,1201726,1305253,918041,109501,6998336,33.33,6.67
Tender_6763,6864896,4292452,201868,517203,457654,12334073,41.0,5.9
Tender_6764,2187450,2356895,1106240,154229,435864,6240678,37.67,6.23
Tender_6765,350951,3872085,2443955,343418,469715,7480124,31.67,6.83
Tender_6766,477100,4327953,1626189,958299,61149,7450690,45.0,5.5
Tender_6767,4708770,2579978,1057833,92162,102106,8540849,47.67,5.23
Tender_6768,7495267,3935833,1784608,671958,50768,13938434,42.0,5.8
Tender_6769,539394,2792574,1445704,725705,174511,5677888,42.0,5.8
Tender_6770,5774964,1531571,147152,463770,243685,8161142,35.0,6.5
Tender_6771,2028866,1477965,2316452,125499,180105,6128887,28.0,7.2
Tender_6772,236362,4329522,2998202,668442,82600,8315128,31.0,6.9
Tender_6773,585630,634222,2151100,601758,187389,4160099,41.33,5.87
Tender_6774,1830805,3208937,710373,351133,326028,6427276,37.33,6.27
Tender_6775,9660946,2931075,2652793,306021,185257,15736092,32.33,6.77
Tender_6776,5930402,749332,77418,850271,301694,7909117,21.0,7.9
Tender_6777,254856,2752972,917685,823482,264757,5013752,34.0,6.6
Tender_6778,979787,3506765,461246,868433,360757,6176988,40.0,6.0
Tender_6779,9555999,1657703,534302,785973,311306,12845283,19.0,8.1
Tender_6780,8074287,2602223,2360967,238555,477195,13753227,56.33,4.37
Tender_6781,3045329,2063640,1818796,233744,487980,7649489,34.67,6.53
Tender_6782,6831585,4205816,88240,948556,422144,12496341,30.67,6.93
Tender_6783,4754327,1271702,2582509,80178,149556,8838272,43.67,5.63
Tender_6784,7220666,2747703,309721,257977,364818,10900885,23.33,7.67
Tender_6785,2605575,1237823,2486172,218268,302727,6850565,37.33,6.27
Tender_6786,7744389,389554,2782631,432392,115246,11464212,35.33,6.47
Tender_6787,1907701,2385610,521183,361301,498369,5674164,34.67,6.53
Tender_6788,7207232,1833058,1745329,346667,262081,11394367,41.0,5.9
Tender_6789,7843224,386346,1685676,90191,202993,10208430,44.0,5.6
Tender_6790,6088938,897135,1668990,618948,304365,9578376,50.0,5.0
Tender_6791,2379509,3496130,1868360,908044,375268,9027311,29.67,7.03
Tender_6792,358752,581640,1483077,176867,466157,3066493,39.33,6.07
Tender_6793,6261175,2519740,2739919,312021,428439,12261294,46.0,5.4
Tender_6794,9823474,1267936,282109,566996,372615,12313130,40.33,5.97
Tender_6795,4304231,3574995,2388966,899756,54713,11222661,41.0,5.9
Tender_6796,5792567,2032629,1585878,223768,376571,10011413,29.0,7.1
Tender_6797,4609070,4246769,1746355,793930,308339,11704463,45.33,5.47
Tender_6798,1513721,3205457,647249,558726,199455,6124608,39.67,6.03
Tender_6799,6394566,4124098,1107207,791962,124399,12542232,23.0,7.7
Tender_6800,8543978,1635604,1423659,545087,418607,12566935,27.67,7.23
Tender_6801,2842358,4895118,1459621,508369,422327,10127793,49.0,5.1
Tender_6802,4142146,4348845,1461963,826067,123827,10902848,23.67,7.63
Tender_6803,9916125,2666728,874730,308318,178337,13944238,43.0,5.7
Tender_6804,8519851,3375571,2220842,154086,239354,14509704,50.67,4.93
Tender_6805,4560446,4456491,416830,925774,68937,10428478,35.0,6.5
Tender_6806,3304817,3140968,2910230,150631,136826,9643472,45.33,5.47
Tender_6807,4424119,4367721,265288,766545,348338,10172011,28.0,7.2
Tender_6808,7973792,2966515,2633652,382113,112930,14069002,28.67,7.13
Tender_6809,4949250,3937263,202002,115715,151738,9355968,37.67,6.23
Tender_6810,2702653,3545390,1170559,928473,379318,8726393,44.67,5.53
Tender_6811,5658357,353016,693299,854739,377248,7936659,37.33,6.27
Tender_6812,9273588,3212112,2434488,969836,167910,16057934,37.33,6.27
Tender_6813,1809252,245457,2177281,310754,392075,4934819,44.0,5.6
Tender_6814,9949844,2801534,1571025,477146,407992,15207541,49.33,5.07
Tender_6815,5500111,4044017,1716062,895093,82753,12238036,41.33,5.87
Tender_6816,8449696,3149533,1373475,462812,147893,13583409,40.67,5.93
Tender_6817,5390185,4928156,2352751,432417,468407,13571916,44.33,5.57
Tender_6818,7390479,4055328,1561001,159272,455379,13621459,30.0,7.0
Tender_6819,5669232,3123414,446195,870721,163822,10273384,40.0,6.0
Tender_6820,1703497,1750819,1074384,774604,353360,5656664,47.0,5.3
Tender_6821,9835767,1468235,2035367,823194,134165,14296728,49.0,5.1
Tender_6822,9137416,4872445,2632932,297940,421657,17362390,41.33,5.87
Tender_6823,5173467,792863,2082491,73749,476907,8599477,45.33,5.47
Tender_6824,7302980,4570041,723833,503971,348490,13449315,17.33,8.27
Tender_6825,6480234,4532752,2103643,545794,86001,13748424,48.33,5.17
Tender_6826,6552947,997970,1409365,677906,205808,9843996,37.0,6.3
Tender_6827,3744214,2230838,1111456,852732,347673,8286913,37.67,6.23
Tender_6828,2047560,442431,1538194,134854,274638,4437677,32.0,6.8
Tender_6829,6842494,2985631,2249916,900964,293170,13272175,51.33,4.87
Tender_6830,696430,2452173,386939,268863,173301,3977706,46.33,5.37
Tender_6831,3617705,4300574,1234851,288514,162385,9604029,34.67,6.53
Tender_6832,3299378,2208014,1014087,634644,95985,7252108,30.33,6.97
Tender_6833,9605282,3569886,76424,319521,71714,13642827,40.0,6.0
Tender_6834,9492501,3102671,661679,288649,261102,13806602,30.0,7.0
Tender_6835,8780571,1547344,858216,792510,61736,12040377,44.67,5.53
Tender_6836,4529599,4969224,1252687,347699,56772,11155981,29.67,7.03
Tender_6837,9173258,780357,1513995,812165,481147,12760922,28.67,7.13
Tender_6838,9801985,4581976,2602541,464578,355224,17806304,31.33,6.87
Tender_6839,8311655,1737160,2536185,286762,466216,13337978,48.67,5.13
Tender_6840,9562436,3127078,2435465,743904,478255,16347138,30.33,6.97
Tender_6841,5282687,4481917,702836,124285,257904,10849629,53.0,4.7
Tender_6842,1963425,533834,2085093,597194,131778,5311324,31.0,6.9
Tender_6843,8485320,3164342,1193145,829280,96588,13768675,37.33,6.27
Tender_6844,2320518,4681730,1733988,349654,239851,9325741,43.0,5.7
Tender_6845,7423422,1754936,2839993,514526,355525,12888402,21.0,7.9
Tender_6846,4000890,523242,1822581,457880,392878,7197471,41.67,5.83
Tender_6847,6177355,3823397,769618,166087,385746,11322203,26.33,7.37
Tender_6848,2440800,3333088,2851172,223391,192251,9040702,51.0,4.9
Tender_6849,8908891,4669678,487204,374947,446655,14887375,39.0,6.1
Tender_6850,9440739,1247666,1766782,84606,333137,12872930,52.67,4.73
Tender_6851,2507398,112361,2966477,459111,67635,6112982,46.33,5.37
Tender_6852,8624645,2769590,2045285,767108,218126,14424754,27.67,7.23
Tender_6853,374656,2205991,2288862,991054,321499,6182062,47.67,5.23
Tender_6854,9080273,1238887,1379836,203883,278085,12180964,32.33,6.77
Tender_6855,2895403,3442364,1536830,677721,465733,9018051,34.67,6.53
Tender_6856,3802382,298261,1432373,753832,423468,6710316,19.0,8.1
Tender_6857,1834215,1286165,1922154,263408,409482,5715424,28.0,7.2
Tender_6858,5434704,2436199,1801594,517988,358051,10548536,29.33,7.07
Tender_6859,3430999,2411924,74211,580145,105634,6602913,29.0,7.1
Tender_6860,839011,1156577,1434159,665156,392225,4487128,38.33,6.17
Tender_6861,2751556,1111961,2165997,395241,373030,6797785,28.33,7.17
Tender_6862,6061300,881057,2035489,768967,218718,9965531,43.0,5.7
Tender_6863,2699929,4156961,2369562,358975,248403,9833830,42.33,5.77
Tender_6864,865174,2016267,2628561,104760,176193,5790955,44.67,5.53
Tender_6865,394337,4320898,533764,930702,350477,6530178,24.67,7.53
Tender_6866,2326448,2461987,1949867,333262,449691,7521255,31.33,6.87
Tender_6867,9848873,3331520,1677473,559497,469134,15886497,48.67,5.13
Tender_6868,8868249,1391845,944843,740307,485222,12430466,39.67,6.03
Tender_6869,708563,3880223,2591834,961156,155079,8296855,50.0,5.0
Tender_6870,5063411,2298791,85045,565160,475816,8488223,25.0,7.5
Tender_6871,2912941,2191253,690930,554637,383387,6733148,33.67,6.63
Tender_6872,7153290,3549060,2583782,664938,480390,14431460,32.33,6.77
Tender_6873,9828377,4794571,1688202,310054,313323,16934527,49.67,5.03
Tender_6874,9383170,2687799,1204191,976257,393946,14645363,31.0,6.9
Tender_6875,961373,4643788,191115,228683,265225,6290184,31.67,6.83
Tender_6876,9297669,3148921,2211537,975812,229058,15862997,35.33,6.47
Tender_6877,8225091,385682,580387,852764,106141,10150065,33.33,6.67
Tender_6878,9316071,3814060,447014,108830,254886,13940861,38.0,6.2
Tender_6879,3106367,285623,2187119,579640,68206,6226955,28.33,7.17
Tender_6880,5500543,658891,1223220,914032,184620,8481306,26.67,7.33
Tender_6881,4167698,2110106,2452343,188261,485548,9403956,61.33,3.87
Tender_6882,4586747,2636808,1599923,619419,496291,9939188,48.33,5.17
Tender_6883,6527479,1266462,2790046,774583,329513,11688083,40.33,5.97
Tender_6884,8507005,1564692,2292082,369404,380558,13113741,55.67,4.43
Tender_6885,207958,2011004,2799240,159347,261687,5439236,53.67,4.63
Tender_6886,7641703,2820544,205992,595188,353033,11616460,54.0,4.6
Tender_6887,8661481,2758475,1742303,713631,445569,14321459,31.33,6.87
Tender_6888,5722326,296978,1181822,635338,109423,7945887,38.67,6.13
Tender_6889,820406,2419620,1451963,649430,134600,5476019,33.67,6.63
Tender_6890,7506177,2670863,2554160,340713,371197,13443110,30.0,7.0
Tender_6891,1386286,312509,2502675,970653,77121,5249244,26.67,7.33
Tender_6892,6627808,3216180,1844310,483408,274686,12446392,37.0,6.3
Tender_6893,1330321,4292998,1022125,657457,222772,7525673,44.33,5.57
Tender_6894,4381074,1029565,439685,389553,416366,6656243,23.0,7.7
Tender_6895,2176255,540633,2288656,623906,332431,5961881,46.33,5.37
Tender_6896,2739514,3719747,2250231,981849,143531,9834872,33.33,6.67
Tender_6897,2231915,1183490,2102329,748247,333761,6599742,34.0,6.6
Tender_6898,7906222,370787,2729303,331085,144579,11481976,18.67,8.13
Tender_6899,9052797,4375586,530712,567356,108844,14635295,32.0,6.8
Tender_6900,9157067,375857,2675694,178742,101760,12489120,58.33,4.17
Tender_6901,9172306,1381407,2276644,265214,166305,13261876,35.67,6.43
Tender_6902,8929201,124857,2033523,888961,234876,12211418,35.67,6.43
Tender_6903,1649331,1050368,2549666,473265,376794,6099424,35.0,6.5
Tender_6904,7490444,961449,2269239,735800,114154,11571086,31.0,6.9
Tender_6905,3283317,529847,2195171,592322,380075,6980732,26.67,7.33
Tender_6906,6782112,2253455,2762610,491797,258858,12548832,41.67,5.83
Tender_6907,7286195,839920,797148,319892,105290,9348445,53.0,4.7
Tender_6908,6954240,1308979,850018,903998,151608,10168843,34.67,6.53
Tender_6909,8722915,3134739,1508081,718852,262388,14346975,27.67,7.23
Tender_6910,8193439,4377367,523631,249703,485202,13829342,33.33,6.67
Tender_6911,4705345,4344326,2518454,482229,453468,12503822,58.33,4.17
Tender_6912,2548099,3547592,1882524,637525,231384,8847124,31.0,6.9
Tender_6913,2887840,469258,132549,169307,306550,3965504,20.0,8.0
Tender_6914,4166625,2548896,2437652,204393,58067,9415633,35.0,6.5
Tender_6915,4018968,3393362,1606399,590776,219285,9828790,43.33,5.67
Tender_6916,9094429,102095,2172330,120491,449720,11939065,48.33,5.17
Tender_6917,5020207,1244087,1679037,826340,355906,9125577,39.33,6.07
Tender_6918,5309151,1455232,304591,135295,201974,7406243,51.33,4.87
Tender_6919,5428283,2728241,1446174,556673,414813,10574184,34.67,6.53
Tender_6920,6906722,472282,2879008,277611,337528,10873151,30.33,6.97
Tender_6921,1347791,1501894,119823,753535,139458,3862501,36.0,6.4
Tender_6922,1729521,361726,1450017,129798,410626,4081688,54.33,4.57
Tender_6923,7925884,1141955,1536597,987281,459882,12051599,31.33,6.87
Tender_6924,9728028,981682,2165595,52780,364183,13292268,42.0,5.8
Tender_6925,5517124,4645681,447912,383486,137229,11131432,26.33,7.37
Tender_6926,5264887,4310974,1305205,222013,370901,11473980,38.33,6.17
Tender_6927,6374215,2827727,2828098,764725,324396,13119161,38.0,6.2
Tender_6928,7889834,2918790,1965681,834210,184483,13792998,35.0,6.5
Tender_6929,1329557,1472088,2475140,838502,287776,6403063,38.67,6.13
Tender_6930,1596959,3411164,2767822,133932,338584,8248461,43.67,5.63
Tender_6931,7600265,813397,2904218,395335,151826,11865041,44.0,5.6
Tender_6932,375422,4209067,486270,483617,229441,5783817,36.33,6.37
Tender_6933,5141708,1271884,702252,241386,54852,7412082,29.67,7.03
Tender_6934,4495952,4431276,821344,572398,105183,10426153,60.67,3.93
Tender_6935,5391397,1240108,1599418,634768,263867,9129558,42.0,5.8
Tender_6936,1392942,4207184,531350,825256,357253,7313985,42.0,5.8
Tender_6937,6296899,437225,1453227,267779,168743,8623873,35.0,6.5
Tender_6938,3427971,1173021,2051207,124200,366308,7142707,32.67,6.73
Tender_6939,6678587,3260503,1478793,880617,403315,12701815,33.33,6.67
Tender_6940,2240806,1100802,961979,181708,497952,4983247,35.33,6.47
Tender_6941,4523044,1184317,2196317,287939,176599,8368216,53.67,4.63
Tender_6942,5818853,3235067,223867,901741,156051,10335579,57.67,4.23
Tender_6943,1407142,4831387,2503090,339047,471167,9551833,47.67,5.23
Tender_6944,9288183,1166423,535223,203597,389693,11583119,54.67,4.53
Tender_6945,3864723,3790841,1560091,694077,275985,10185717,47.0,5.3
Tender_6946,1442995,4969875,2313333,765885,103204,9595292,41.0,5.9
Tender_6947,4046030,4224404,2948636,909755,218786,12347611,36.67,6.33
Tender_6948,2735500,3504024,2208052,717480,346438,9511494,39.33,6.07
Tender_6949,1788703,137911,1180661,688103,74109,3869487,37.67,6.23
Tender_6950,9035919,2207962,2434928,222807,291026,14192642,30.0,7.0
Tender_6951,2041586,481723,309696,452563,144672,3430240,42.33,5.77
Tender_6952,6524817,1629477,605310,317013,279267,9355884,24.67,7.53
Tender_6953,8139623,3883602,2262458,963207,271830,15520720,53.0,4.7
Tender_6954,866549,1020333,2524663,552022,388446,5352013,38.33,6.17
Tender_6955,5262127,4570425,451013,452945,389853,11126363,37.0,6.3
Tender_6956,9984843,1872097,304996,730117,422467,13314520,42.0,5.8
Tender_6957,1943788,216722,1127296,686530,399752,4374088,52.67,4.73
Tender_6958,6231900,1078434,468194,484543,438557,8701628,28.0,7.2
Tender_6959,6796382,192948,508056,386015,427206,8310607,36.33,6.37
Tender_6960,2019180,516463,244489,908800,301007,3989939,35.33,6.47
Tender_6961,387538,4425126,2562636,103606,86818,7565724,31.33,6.87
Tender_6962,1178979,2377439,2000102,307188,265996,6129704,39.0,6.1
Tender_6963,8363507,4992128,2604866,63193,121590,16145284,40.33,5.97
Tender_6964,2346019,3034738,2852050,117702,401622,8752131,54.33,4.57
Tender_6965,7445076,1328883,2844508,884571,490124,12993162,40.0,6.0
Tender_6966,1238575,2970526,764623,601615,215063,5790402,46.67,5.33
Tender_6967,8024081,2288623,2514509,403561,252481,13483255,27.33,7.27
Tender_6968,6587639,426273,878730,69180,130333,8092155,45.0,5.5
Tender_6969,8798291,172380,2896255,522349,248115,12637390,44.67,5.53
Tender_6970,6100102,1872033,1699713,718256,277269,10667373,23.0,7.7
Tender_6971,1387779,3157167,717318,559357,441941,6263562,45.0,5.5
Tender_6972,7261948,1040969,1390971,247656,236830,10178374,36.0,6.4
Tender_6973,5084185,4747530,2397898,81873,301618,12613104,28.33,7.17
Tender_6974,1150964,4375767,1305511,700392,330198,7862832,36.33,6.37
Tender_6975,7327451,1878197,184538,441415,103982,9935583,42.0,5.8
Tender_6976,5030880,2425954,1275603,407443,252465,9392345,37.33,6.27
Tender_6977,759064,2752882,123717,750341,243346,4629350,45.0,5.5
Tender_6978,1063770,4233383,2483597,689797,291350,8761897,37.0,6.3
Tender_6979,5845816,3323936,899929,816430,460950,11347061,37.0,6.3
Tender_6980,9447876,2480617,1092272,566431,197714,13784910,36.0,6.4
Tender_6981,5029757,4832794,1894757,520615,468051,12745974,48.33,5.17
Tender_6982,5138164,2608135,910814,708146,246549,9611808,35.33,6.47
Tender_6983,6022636,3812872,782019,170148,469314,11256989,28.33,7.17
Tender_6984,1928569,4341684,1656870,327439,318713,8573275,42.0,5.8
Tender_6985,2453362,3908233,190793,273439,61499,6887326,28.0,7.2
Tender_6986,8632638,1400211,2380859,709144,126663,13249515,34.33,6.57
Tender_6987,3074574,3342093,93255,886711,313629,7710262,48.67,5.13
Tender_6988,8291496,4965949,2181380,726217,385914,16550956,29.33,7.07
Tender_6989,2550919,692452,790440,998519,118096,5150426,51.67,4.83
Tender_6990,4588421,798654,2296626,776683,485141,8945525,43.33,5.67
Tender_6991,2881873,3499529,1903166,504061,195209,8983838,52.33,4.77
Tender_6992,9181056,766107,808688,641882,74184,11471917,49.67,5.03
Tender_6993,9331209,3543913,897072,827798,432622,15032614,37.33,6.27
Tender_6994,1464739,2265524,2298283,150449,488313,6667308,49.67,5.03
Tender_6995,2047951,3365057,2383732,516287,382567,8695594,32.67,6.73
Tender_6996,7292281,3304124,1596689,120308,121847,12435249,28.33,7.17
Tender_6997,7456519,3396538,1737671,386732,410336,13387796,44.67,5.53
Tender_6998,4960028,1918482,2906683,688057,433946,10907196,32.33,6.77
Tender_6999,8180895,1645369,2940619,753787,103216,13623886,26.67,7.33
Tender_7000,2922724,3752942,1434015,139756,66792,8316229,27.33,7.27
Tender_7001,4726674,3709908,1743442,886353,93229,11159606,43.67,5.63
Tender_7002,9004457,1972406,1809321,186508,360469,13333161,33.0,6.7
Tender_7003,4333670,775445,1593615,109480,453426,7265636,35.0,6.5
Tender_7004,2798801,4402630,1293838,345868,406335,9247472,38.67,6.13
Tender_7005,5494923,4654047,2883477,447432,141992,13621871,35.67,6.43
Tender_7006,5596305,1237906,2274670,371429,149857,9630167,37.33,6.27
Tender_7007,8509733,3791942,1829117,359212,430210,14920214,50.33,4.97
Tender_7008,5234074,4323118,629573,358654,294051,10839470,42.33,5.77
Tender_7009,9451763,3955446,299827,474728,74938,14256702,42.0,5.8
Tender_7010,6336644,3305658,592390,185119,128889,10548700,37.67,6.23
Tender_7011,2021074,4655556,2958935,542649,270325,10448539,20.67,7.93
Tender_7012,3872837,1353636,2802679,326143,255126,8610421,43.33,5.67
Tender_7013,3658092,2555879,1642798,121151,350075,8327995,50.67,4.93
Tender_7014,8576459,3207755,961658,272534,403354,13421760,53.67,4.63
Tender_7015,6100429,4459221,1643323,757808,104825,13065606,28.0,7.2
Tender_7016,9947650,2641147,2592832,685864,363706,16231199,49.0,5.1
Tender_7017,9907332,4347254,1459957,559229,481490,16755262,41.67,5.83
Tender_7018,3526484,2773366,2224709,969852,110513,9604924,31.67,6.83
Tender_7019,3951217,823541,214486,369159,241495,5599898,56.67,4.33
Tender_7020,4488969,3404480,100527,488469,305209,8787654,36.67,6.33
Tender_7021,6359423,3709193,100324,475475,138808,10783223,34.33,6.57
Tender_7022,9461805,1628831,2742232,693796,254704,14781368,31.67,6.83
Tender_7023,3337836,3674507,1109956,644964,228412,8995675,49.0,5.1
Tender_7024,3675681,1970086,2359065,874017,133076,9011925,43.33,5.67
Tender_7025,9399054,2980349,2823307,291889,398110,15892709,52.33,4.77
Tender_7026,9144436,3788635,2561087,368655,385302,16248115,34.0,6.6
Tender_7027,1683165,2815004,434483,798656,427610,6158918,30.67,6.93
Tender_7028,8624121,2586239,1755925,504562,463196,13934043,45.67,5.43
Tender_7029,8399095,4379348,2389995,865091,494467,16527996,37.67,6.23
Tender_7030,2075474,2560300,1543749,364941,100438,6644902,29.33,7.07
Tender_7031,6865651,2868844,2363327,674861,411672,13184355,38.33,6.17
Tender_7032,4440972,1551173,2862030,111686,158720,9124581,26.0,7.4
Tender_7033,6629655,2612603,2986948,885068,278320,13392594,42.0,5.8
Tender_7034,7567250,355093,1346939,423123,230562,9922967,36.0,6.4
Tender_7035,5980160,3003217,312253,770954,408126,10474710,50.0,5.0
Tender_7036,7454139,2328358,1793618,534209,415442,12525766,50.67,4.93
Tender_7037,9627071,1043055,1505887,379516,493667,13049196,21.33,7.87
Tender_7038,2481370,3564909,2783021,220813,133912,9184025,37.67,6.23
Tender_7039,3247472,4592093,535701,52755,435697,8863718,44.0,5.6
Tender_7040,5400010,1752885,395555,525716,188169,8262335,37.67,6.23
Tender_7041,7853484,1771916,1868271,986353,159452,12639476,36.33,6.37
Tender_7042,7020246,1108148,2826594,230711,347825,11533524,42.0,5.8
Tender_7043,8909937,2325117,872735,845299,206076,13159164,29.67,7.03
Tender_7044,737411,1591245,2655061,374875,157412,5516004,32.0,6.8
Tender_7045,8125909,1058614,2653008,632006,461813,12931350,42.67,5.73
Tender_7046,2485276,2683881,895258,731154,224363,7019932,30.33,6.97
Tender_7047,5732821,4020894,476148,485688,274163,10989714,26.0,7.4
Tender_7048,8065496,1594664,2413971,259576,388085,12721792,36.67,6.33
Tender_7049,9772258,2091242,1995644,162003,334152,14355299,35.0,6.5
Tender_7050,7624088,4441802,1079138,744367,393290,14282685,26.0,7.4
Tender_7051,6180273,371059,999635,121216,182858,7855041,36.67,6.33
Tender_7052,1421209,1695851,251831,300271,420633,4089795,47.0,5.3
Tender_7053,3383511,1419038,2811948,336676,60456,8011629,48.33,5.17
Tender_7054,1759825,3878623,2829534,261830,70140,8799952,27.0,7.3
Tender_7055,5631566,515169,2175434,282401,260957,8865527,32.33,6.77
Tender_7056,4873462,2834976,1736516,929378,450856,10825188,45.67,5.43
Tender_7057,7217480,2885691,2186730,719638,419955,13429494,28.33,7.17
Tender_7058,3347897,2606800,2640481,638232,466175,9699585,35.67,6.43
Tender_7059,7300127,2437803,1062969,147944,451770,11400613,55.67,4.43
Tender_7060,8566516,171519,2665394,247763,230248,11881440,39.0,6.1
Tender_7061,7284548,1517520,2075274,210139,420226,11507707,37.67,6.23
Tender_7062,2736095,4164933,2118336,61659,332588,9413611,41.0,5.9
Tender_7063,1943711,2581491,1904111,730687,249389,7409389,33.67,6.63
Tender_7064,3841784,883584,2954709,161658,90094,7931829,39.33,6.07
Tender_7065,7478910,1553928,264488,501152,226423,10024901,25.0,7.5
Tender_7066,406231,2197273,1307911,73844,484701,4469960,47.33,5.27
Tender_7067,7469844,1977265,833852,549277,315663,11145901,54.67,4.53
Tender_7068,2675435,1407359,1517529,451057,181265,6232645,49.33,5.07
Tender_7069,4984042,149934,2792543,203775,452432,8582726,32.0,6.8
Tender_7070,4823967,2884631,560486,453489,170733,8893306,50.0,5.0
Tender_7071,4672285,4534468,2432952,405923,229066,12274694,37.33,6.27
Tender_7072,8002993,1435945,2516356,81463,343477,12380234,26.67,7.33
Tender_7073,3273726,345902,1485365,497444,479009,6081446,32.33,6.77
Tender_7074,8565895,4096889,781467,377611,392102,14213964,25.0,7.5
Tender_7075,2467658,228419,2499985,948046,410061,6554169,29.0,7.1
Tender_7076,5423811,2288032,272067,887549,111443,8982902,24.0,7.6
Tender_7077,6148500,1356580,1047710,955337,211028,9719155,26.67,7.33
Tender_7078,5610293,3328460,163807,840395,374291,10317246,27.33,7.27
Tender_7079,8360457,3759452,1799917,817341,493946,15231113,45.33,5.47
Tender_7080,6739673,910221,2596458,79630,82841,10408823,50.33,4.97
Tender_7081,9163399,2152511,1580301,274897,406546,13577654,44.33,5.57
Tender_7082,8580362,3282504,1816126,984450,314220,14977662,33.67,6.63
Tender_7083,5443637,4018209,2618308,476748,467379,13024281,45.67,5.43
Tender_7084,1329680,3588941,1295055,617063,327599,7158338,46.0,5.4
Tender_7085,1956336,1725080,2976620,362313,382993,7403342,41.67,5.83
Tender_7086,4984941,2673698,1596383,50006,125159,9430187,34.67,6.53
Tender_7087,9066850,4475446,2566787,815031,204293,17128407,43.0,5.7
Tender_7088,4387458,3137181,2119427,474415,157745,10276226,28.67,7.13
Tender_7089,3593654,1210133,1329716,885825,278693,7298021,51.33,4.87
Tender_7090,3933042,4613346,2740343,668486,467653,12422870,52.33,4.77
Tender_7091,6868640,2829464,525161,521846,436977,11182088,22.0,7.8
Tender_7092,3715161,1327935,1360574,218492,495250,7117412,38.67,6.13
Tender_7093,9697469,2738389,1407486,215225,419462,14478031,53.33,4.67
Tender_7094,7441266,4407808,493966,423480,304125,13070645,45.67,5.43
Tender_7095,705728,159985,2270151,761675,236351,4133890,30.0,7.0
Tender_7096,1324792,1841591,2111326,534971,411916,6224596,29.0,7.1
Tender_7097,5432785,900700,965915,246015,402997,7948412,33.67,6.63
Tender_7098,4757964,1355077,1707722,307345,341017,8469125,24.33,7.57
Tender_7099,8464941,315335,1576845,721777,68281,11147179,41.67,5.83
Tender_7100,2100675,1022836,499846,120987,73013,3817357,42.67,5.73
Tender_7101,6314705,2004612,1616355,182204,254127,10372003,43.33,5.67
Tender_7102,9894487,1512537,2201789,163582,266164,14038559,48.0,5.2
Tender_7103,9822202,4148729,1506291,88773,132430,15698425,47.0,5.3
Tender_7104,7890702,3435414,1240420,522442,137300,13226278,41.0,5.9
Tender_7105,8516675,4400506,1050265,242648,305874,14515968,51.0,4.9
Tender_7106,1461957,2937784,1273799,840720,309868,6824128,31.33,6.87
Tender_7107,9853322,3191700,1462115,446303,95010,15048450,51.33,4.87
Tender_7108,4537782,4879002,2499023,856526,411774,13184107,30.33,6.97
Tender_7109,4784349,3492422,795327,895979,131312,10099389,29.33,7.07
Tender_7110,5708020,2802975,106030,916311,105938,9639274,48.67,5.13
Tender_7111,6304041,1417606,695666,370933,55522,8843768,29.67,7.03
Tender_7112,6787336,747695,494749,208063,136787,8374630,28.33,7.17
Tender_7113,1517757,836685,1080157,563570,75542,4073711,32.33,6.77
Tender_7114,4619495,4095106,1278987,245516,389957,10629061,39.67,6.03
Tender_7115,848363,4212011,2386155,388572,306298,8141399,24.67,7.53
Tender_7116,7822243,4723809,687885,116715,209508,13560160,39.67,6.03
Tender_7117,7811798,242105,280964,468339,178294,8981500,50.67,4.93
Tender_7118,5383042,194392,775089,90079,419081,6861683,47.0,5.3
Tender_7119,1613121,1504126,1225633,858237,116331,5317448,41.33,5.87
Tender_7120,8727181,4298712,1815647,763365,460036,16064941,25.33,7.47
Tender_7121,4922744,1043610,964867,673850,97043,7702114,30.0,7.0
Tender_7122,1929907,558941,878611,903175,79152,4349786,33.33,6.67
Tender_7123,2589026,2785877,2149638,491010,229216,8244767,51.33,4.87
Tender_7124,6582600,4826368,1047877,324025,277116,13057986,34.67,6.53
Tender_7125,4428491,1878747,808177,533353,371645,8020413,44.33,5.57
Tender_7126,684156,278356,2204148,562147,419619,4148426,44.33,5.57
Tender_7127,5662682,2163299,294000,138284,66485,8324750,49.0,5.1
Tender_7128,4344036,557517,819182,473411,112305,6306451,37.33,6.27
Tender_7129,6273648,3268613,2366835,393372,458128,12760596,31.0,6.9
Tender_7130,2468598,2715780,2690034,269355,282313,8426080,36.67,6.33
Tender_7131,3908307,1130468,2010053,415852,104954,7569634,26.33,7.37
Tender_7132,3124292,3258901,2910304,340476,259181,9893154,41.0,5.9
Tender_7133,2463005,4289383,940859,301033,189792,8184072,24.67,7.53
Tender_7134,7960430,281608,1406728,888569,243865,10781200,40.33,5.97
Tender_7135,7006387,1484195,1023391,313484,192683,10020140,47.0,5.3
Tender_7136,8348679,792986,2802070,508511,202325,12654571,25.33,7.47
Tender_7137,3395707,2629244,2570248,674473,111993,9381665,40.67,5.93
Tender_7138,1189755,4843563,1123720,684676,99366,7941080,48.33,5.17
Tender_7139,5662246,1660149,565741,756239,422458,9066833,49.67,5.03
Tender_7140,7831876,559374,493035,371616,143727,9399628,57.67,4.23
Tender_7141,3229391,4020567,1905476,800147,449354,10404935,26.0,7.4
Tender_7142,2199918,4404924,1037073,598025,226426,8466366,47.33,5.27
Tender_7143,8757910,1677986,1896766,66200,87073,12485935,22.0,7.8
Tender_7144,7427025,2414002,359099,391814,284887,10876827,32.33,6.77
Tender_7145,4881172,108947,1984645,559604,162592,7696960,39.67,6.03
Tender_7146,5858995,943018,2332377,115741,460556,9710687,34.33,6.57
Tender_7147,3910986,264963,1330140,977546,443247,6926882,34.67,6.53
Tender_7148,2371078,3974028,1564832,589456,424416,8923810,42.0,5.8
Tender_7149,7506646,3951693,2235744,141042,453803,14288928,42.33,5.77
Tender_7150,1747890,1216593,2106138,635584,320862,6027067,43.67,5.63
Tender_7151,6945515,3041107,1489850,572958,388321,12437751,60.0,4.0
Tender_7152,1482056,211287,2358578,597786,195693,4845400,34.0,6.6
Tender_7153,8063358,1197155,1658029,135259,94431,11148232,38.67,6.13
Tender_7154,4523168,1123735,2775718,927282,388319,9738222,45.67,5.43
Tender_7155,9808690,480300,792267,557367,307271,11945895,23.0,7.7
Tender_7156,9677322,4684528,2382562,530952,246400,17521764,47.67,5.23
Tender_7157,3924851,2939791,1424428,86777,65599,8441446,49.67,5.03
Tender_7158,4863146,4997233,2039997,683969,394931,12979276,26.33,7.37
Tender_7159,5991709,1922133,1187248,556787,148084,9805961,38.33,6.17
Tender_7160,2933085,573624,867639,461855,469596,5305799,35.67,6.43
Tender_7161,2986816,3708446,934507,251889,124970,8006628,28.33,7.17
Tender_7162,7699706,110282,449655,245409,303114,8808166,48.0,5.2
Tender_7163,1878871,4388233,513244,691705,335559,7807612,37.0,6.3
Tender_7164,8878303,2385241,1790018,807730,167363,14028655,28.33,7.17
Tender_7165,380779,1752325,1223231,206009,398641,3960985,18.0,8.2
Tender_7166,6143334,4360366,1930960,269029,104279,12807968,30.0,7.0
Tender_7167,5469228,1339190,2296055,516760,113528,9734761,46.33,5.37
Tender_7168,4629745,860444,2535348,251076,253945,8530558,36.0,6.4
Tender_7169,8444043,2144543,1725254,189731,351236,12854807,42.33,5.77
Tender_7170,1052648,3237333,333452,888061,228976,5740470,49.33,5.07
Tender_7171,1133313,1703839,288007,265353,126753,3517265,55.0,4.5
Tender_7172,7179426,2384817,1452430,416411,180179,11613263,42.33,5.77
Tender_7173,9574106,855692,837820,171298,241447,11680363,41.0,5.9
Tender_7174,9078544,1086455,1837201,971854,434015,13408069,51.33,4.87
Tender_7175,8331271,4403142,138891,351716,421116,13646136,35.33,6.47
Tender_7176,4169102,4156728,2100693,866487,366245,11659255,53.0,4.7
Tender_7177,275957,1298047,1241082,213355,434141,3462582,29.67,7.03
Tender_7178,2557644,4023760,847143,824103,422349,8674999,21.67,7.83
Tender_7179,9639185,2378235,1046390,289850,151781,13505441,49.33,5.07
Tender_7180,7202064,1559393,2472564,833393,345331,12412745,36.33,6.37
Tender_7181,2368031,1725392,2324377,791800,139582,7349182,28.33,7.17
Tender_7182,617706,2033634,2499978,803437,393831,6348586,45.67,5.43
Tender_7183,5993476,793464,2421409,386628,139301,9734278,44.33,5.57
Tender_7184,7053357,4001632,2289998,878522,78855,14302364,41.33,5.87
Tender_7185,4331984,2988260,207256,865465,354431,8747396,42.33,5.77
Tender_7186,4101681,3727158,2641292,363784,79387,10913302,49.67,5.03
Tender_7187,6759950,687960,72653,359133,168180,8047876,44.33,5.57
Tender_7188,4545527,1689484,2009232,775880,134778,9154901,22.0,7.8
Tender_7189,1003988,3722734,1497879,306106,494543,7025250,36.33,6.37
Tender_7190,9908526,1761863,253499,242386,195032,12361306,26.67,7.33
Tender_7191,7790969,1070097,1305045,351121,82589,10599821,41.0,5.9
Tender_7192,7047487,1056049,1046529,61582,436821,9648468,45.33,5.47
Tender_7193,2659973,3146235,984763,596992,64559,7452522,50.0,5.0
Tender_7194,9321303,3294060,456190,772243,287061,14130857,37.67,6.23
Tender_7195,2901028,3030134,1585257,467790,136409,8120618,20.33,7.97
Tender_7196,7637155,3125709,2431085,305528,409180,13908657,41.33,5.87
Tender_7197,1628754,2650255,2456345,193770,447975,7377099,26.0,7.4
Tender_7198,2871774,732542,2664540,591385,398966,7259207,48.33,5.17
Tender_7199,9557805,3945797,2359876,260130,106397,16230005,55.33,4.47
Tender_7200,9422735,4714552,2780526,154139,119641,17191593,59.67,4.03
Tender_7201,3157169,605454,2149187,505586,103576,6520972,52.67,4.73
Tender_7202,7081404,4684041,2043139,623568,321828,14753980,42.0,5.8
Tender_7203,4305667,4750134,75363,837568,286620,10255352,31.0,6.9
Tender_7204,2259380,2972308,1165812,213255,338068,6948823,42.0,5.8
Tender_7205,529330,2969353,1753460,760129,442553,6454825,47.33,5.27
Tender_7206,9734225,4242595,585064,451314,422828,15436026,53.33,4.67
Tender_7207,7010404,3396159,2289939,624983,478649,13800134,51.67,4.83
Tender_7208,9360927,2079126,329989,606170,218658,12594870,41.33,5.87
Tender_7209,7845920,2295495,1432917,826714,202995,12604041,23.67,7.63
Tender_7210,3092638,1139170,2580970,234069,388434,7435281,36.33,6.37
Tender_7211,6472125,3732750,1098338,546599,141161,11990973,37.67,6.23
Tender_7212,5229777,1642863,943460,859285,300822,8976207,50.67,4.93
Tender_7213,980566,3229351,1634718,52088,50547,5947270,30.33,6.97
Tender_7214,7581754,1968529,2166037,889518,142120,12747958,25.33,7.47
Tender_7215,8469119,1032872,2162202,588291,61411,12313895,23.0,7.7
Tender_7216,4433862,3682889,2979886,478657,358843,11934137,41.33,5.87
Tender_7217,9242770,2330699,968532,747909,484627,13774537,55.0,4.5
Tender_7218,9090911,340757,240890,906777,207095,10786430,31.67,6.83
Tender_7219,1431871,1548768,530481,730828,220226,4462174,44.67,5.53
Tender_7220,7170355,1861080,2861552,433380,229293,12555660,52.67,4.73
Tender_7221,8717873,3881765,504287,93566,287788,13485279,42.33,5.77
Tender_7222,2745415,2049576,1771157,815390,182618,7564156,37.67,6.23
Tender_7223,376781,4913872,81463,220546,415650,6008312,45.67,5.43
Tender_7224,4878977,1923713,1782667,120799,272658,8978814,27.33,7.27
Tender_7225,3822458,550873,1223221,817561,153274,6567387,38.67,6.13
Tender_7226,2940120,2342331,399874,807403,374166,6863894,39.33,6.07
Tender_7227,8905390,3186610,1661957,279943,347398,14381298,36.0,6.4
Tender_7228,1737880,3979843,1672437,492379,61007,7943546,40.33,5.97
Tender_7229,2464994,2441692,2189756,100828,450378,7647648,40.0,6.0
Tender_7230,7946138,913882,391483,576048,202579,10030130,36.67,6.33
Tender_7231,8342673,1156642,2831777,93138,449926,12874156,43.33,5.67
Tender_7232,3856204,4761494,1082472,456562,176706,10333438,33.33,6.67
Tender_7233,2097730,3694915,1491065,97385,427757,7808852,24.67,7.53
Tender_7234,7838614,272906,2099548,638821,168678,11018567,22.33,7.77
Tender_7235,7981801,2188733,2877224,973926,109304,14130988,50.0,5.0
Tender_7236,5166620,4081643,1845926,283518,402748,11780455,41.67,5.83
Tender_7237,3023829,4128242,1051557,904631,273150,9381409,37.33,6.27
Tender_7238,8276732,4844905,350226,715617,342022,14529502,27.0,7.3
Tender_7239,9193814,335714,527157,131943,126101,10314729,37.0,6.3
Tender_7240,4643660,2913075,2432207,818242,64686,10871870,31.33,6.87
Tender_7241,3376288,2273166,1896884,789247,289675,8625260,46.0,5.4
Tender_7242,8222702,1408955,2520819,548435,280960,12981871,32.33,6.77
Tender_7243,9337576,2775686,763669,334214,323795,13534940,40.67,5.93
Tender_7244,9569350,1937622,552457,717492,243207,13020128,38.67,6.13
Tender_7245,8092328,796351,2161786,760606,136227,11947298,29.67,7.03
Tender_7246,2885083,4094337,1087105,193431,469545,8729501,37.33,6.27
Tender_7247,4729795,297186,410832,890813,286166,6614792,25.0,7.5
Tender_7248,2524772,1185033,2971471,558199,224185,7463660,42.67,5.73
Tender_7249,7938195,4238737,1757694,321672,180375,14436673,18.0,8.2
Tender_7250,6060874,3984320,207452,348837,120242,10721725,33.33,6.67
Tender_7251,8607491,4168729,2180674,605920,439551,16002365,31.67,6.83
Tender_7252,1556797,1548579,2301139,958119,69583,6434217,36.33,6.37
Tender_7253,4776947,924451,2004791,672527,255317,8634033,35.33,6.47
Tender_7254,619666,3940205,1309792,673465,386847,6929975,31.0,6.9
Tender_7255,6614223,4415470,1557941,626914,102075,13316623,52.0,4.8
Tender_7256,5697477,4817704,1062502,616330,482940,12676953,49.33,5.07
Tender_7257,1162314,4227733,1499731,174717,152153,7216648,36.0,6.4
Tender_7258,5762052,1393282,398842,449803,206793,8210772,34.33,6.57
Tender_7259,9360709,4629363,2243195,829705,490413,17553385,29.33,7.07
Tender_7260,335004,3907863,1938910,790311,113008,7085096,32.67,6.73
Tender_7261,9790908,4364960,2369185,636389,447275,17608717,44.33,5.57
Tender_7262,6403355,1396351,1836814,775462,367669,10779651,55.0,4.5
Tender_7263,3796689,3355648,948618,628302,136092,8865349,47.33,5.27
Tender_7264,2003319,2954295,2227224,297110,419621,7901569,58.67,4.13
Tender_7265,7374281,176333,1470064,733421,289961,10044060,42.33,5.77
Tender_7266,5195696,498652,2295852,369970,106662,8466832,57.33,4.27
Tender_7267,7602044,1815806,1248928,575311,150283,11392372,55.0,4.5
Tender_7268,996229,760584,1959880,945713,165457,4827863,26.67,7.33
Tender_7269,6471399,1535462,1986661,797086,346907,11137515,44.33,5.57
Tender_7270,4621280,1852084,632322,357105,287969,7750760,35.0,6.5
Tender_7271,9425800,3229374,2897961,227107,396976,16177218,31.33,6.87
Tender_7272,9515227,2476951,1736855,487247,186060,14402340,48.33,5.17
Tender_7273,8021555,4404280,1947004,240760,474109,15087708,31.67,6.83
Tender_7274,5877055,2034427,2485983,820333,227622,11445420,36.33,6.37
Tender_7275,3403434,3748295,1496130,440588,66874,9155321,36.33,6.37
Tender_7276,4736660,3633701,234554,803732,135204,9543851,34.33,6.57
Tender_7277,802313,1413449,960626,71301,111796,3359485,40.0,6.0
Tender_7278,8302464,2771038,1394648,356758,202043,13026951,36.0,6.4
Tender_7279,3828747,2006566,1497008,130609,238770,7701700,43.33,5.67
Tender_7280,3220762,3253951,2201119,180616,174037,9030485,33.67,6.63
Tender_7281,9219131,4213567,2400930,637644,105889,16577161,31.0,6.9
Tender_7282,5169658,1045816,2653975,389880,97389,9356718,47.33,5.27
Tender_7283,5986422,4713275,225698,896762,243105,12065262,46.0,5.4
Tender_7284,6509454,1865069,2748949,905308,347535,12376315,38.0,6.2
Tender_7285,9309916,1333619,1467053,954181,298337,13363106,48.67,5.13
Tender_7286,8781878,1906828,966046,430039,205870,12290661,42.67,5.73
Tender_7287,9829275,2852952,867957,470033,371569,14391786,28.0,7.2
Tender_7288,4145697,1755880,731360,415022,296864,7344823,38.0,6.2
Tender_7289,2608666,145105,1387070,550893,341323,5033057,39.0,6.1
Tender_7290,2524579,1338548,1449430,498694,384618,6195869,36.67,6.33
Tender_7291,9001944,692882,2128852,156010,278338,12258026,40.67,5.93
Tender_7292,1294408,2965613,1507376,74082,466018,6307497,37.0,6.3
Tender_7293,8249583,2923682,2605078,629611,410939,14818893,39.0,6.1
Tender_7294,1661657,4876748,2062868,987312,384416,9973001,55.67,4.43
Tender_7295,793841,3023695,2836400,220494,267664,7142094,25.67,7.43
Tender_7296,9404529,1660826,1357382,595869,198293,13216899,42.67,5.73
Tender_7297,3333756,1409785,2341568,906827,154369,8146305,32.0,6.8
Tender_7298,2599571,1889797,2848804,592349,370784,8301305,35.0,6.5
Tender_7299,9351031,2063165,2332685,296797,105186,14148864,36.67,6.33
Tender_7300,2208728,985860,2086281,321687,161890,5764446,46.33,5.37
Tender_7301,9686459,2938559,1696514,499355,147094,14967981,32.67,6.73
Tender_7302,4694912,766617,2570357,646839,475091,9153816,46.33,5.37
Tender_7303,1141444,394273,1911091,102575,260048,3809431,37.67,6.23
Tender_7304,3799844,3095464,231122,684209,86910,7897549,22.33,7.77
Tender_7305,3603990,882704,1333217,50653,200844,6071408,34.67,6.53
Tender_7306,4509422,4666966,819831,444745,242077,10683041,35.0,6.5
Tender_7307,9740928,2911433,800189,968692,226669,14647911,29.67,7.03
Tender_7308,8252944,452369,217544,684215,79171,9686243,53.33,4.67
Tender_7309,7875055,4160728,722432,411848,364418,13534481,28.67,7.13
Tender_7310,6217758,4856076,1322263,392018,140028,12928143,52.67,4.73
Tender_7311,4358345,4146793,1226769,313208,214262,10259377,35.67,6.43
Tender_7312,3740773,1148586,1452926,423369,194967,6960621,38.33,6.17
Tender_7313,6642366,1475174,2830951,738280,51674,11738445,35.67,6.43
Tender_7314,7627395,4362364,2241458,453405,325841,15010463,35.67,6.43
Tender_7315,9303633,949604,2618295,833901,171362,13876795,39.33,6.07
Tender_7316,4084283,515851,277437,858969,207929,5944469,37.0,6.3
Tender_7317,6191880,4779040,768712,259655,232776,12232063,48.0,5.2
Tender_7318,8825582,4957737,975339,907489,89531,15755678,33.67,6.63
Tender_7319,9442964,1036646,2110042,253405,127318,12970375,39.0,6.1
Tender_7320,4932021,4780837,192104,385583,345119,10635664,54.33,4.57
Tender_7321,5923907,4334930,595914,210347,99502,11164600,28.33,7.17
Tender_7322,4795355,3825614,1178555,391709,391793,10583026,43.0,5.7
Tender_7323,9950201,169319,177191,241163,376080,10913954,39.0,6.1
Tender_7324,742512,4437108,658293,491341,218287,6547541,30.67,6.93
Tender_7325,9327583,4785916,1139477,128991,495170,15877137,23.33,7.67
Tender_7326,7081141,2896810,2767923,382500,333541,13461915,33.33,6.67
Tender_7327,8389099,507434,521539,655245,385121,10458438,37.67,6.23
Tender_7328,9007125,449235,2180920,624759,297608,12559647,35.67,6.43
Tender_7329,1782940,513256,2075644,828845,74385,5275070,37.0,6.3
Tender_7330,3714585,1951309,2454479,245513,368092,8733978,41.33,5.87
Tender_7331,8647054,4524162,2308663,449501,228204,16157584,31.33,6.87
Tender_7332,2561592,4689804,2079516,588879,140139,10059930,47.0,5.3
Tender_7333,4098454,941083,2168320,150503,276028,7634388,17.67,8.23
Tender_7334,1954915,950524,1413769,774055,159622,5252885,37.0,6.3
Tender_7335,1862633,1956224,2521228,105013,248227,6693325,41.67,5.83
Tender_7336,7035305,1178277,688649,382555,457991,9742777,42.0,5.8
Tender_7337,8583318,363680,2249041,723499,387602,12307140,36.67,6.33
Tender_7338,6867788,2042430,2980249,971237,146533,13008237,26.67,7.33
Tender_7339,4916794,3449585,2928611,496817,282212,12074019,49.0,5.1
Tender_7340,7783310,283739,1686405,190411,193065,10136930,44.33,5.57
Tender_7341,5491794,4820160,2390625,407371,142725,13252675,34.33,6.57
Tender_7342,8941118,3416402,1872621,97021,122667,14449829,43.67,5.63
Tender_7343,4383604,344031,2119632,499278,219086,7565631,49.33,5.07
Tender_7344,4286167,1703732,2921309,444297,344791,9700296,32.0,6.8
Tender_7345,6174488,2001944,532188,624538,215177,9548335,35.0,6.5
Tender_7346,6538801,4237296,1116751,93156,163068,12149072,50.67,4.93
Tender_7347,6563453,2414475,2459567,253493,352181,12043169,28.33,7.17
Tender_7348,4331012,4825759,378088,711590,268319,10514768,35.33,6.47
Tender_7349,8898353,3460424,1859917,455289,176493,14850476,40.33,5.97
Tender_7350,8851405,700364,2506329,104229,228978,12391305,32.0,6.8
Tender_7351,2991341,1514323,1704769,226493,63388,6500314,40.0,6.0
Tender_7352,8759393,3471830,2385874,479057,131539,15227693,38.0,6.2
Tender_7353,2975525,4980045,2978121,382095,354385,11670171,31.0,6.9
Tender_7354,3236104,114902,114156,180528,352538,3998228,41.0,5.9
Tender_7355,7691875,3879091,421893,968892,327980,13289731,44.33,5.57
Tender_7356,347791,1209862,1577744,830760,163049,4129206,45.67,5.43
Tender_7357,6895465,4313766,2797517,999517,406866,15413131,54.67,4.53
Tender_7358,9938539,605963,2766658,450756,398903,14160819,55.0,4.5
Tender_7359,8121229,4044554,2459407,289936,482865,15397991,47.0,5.3
Tender_7360,8574201,2189804,2384122,382648,227544,13758319,36.67,6.33
Tender_7361,7851076,2505626,2392784,725514,222866,13697866,31.67,6.83
Tender_7362,8349064,2550598,1418471,266779,301540,12886452,33.0,6.7
Tender_7363,4162418,3704364,471385,552407,492809,9383383,27.67,7.23
Tender_7364,756617,3268097,62995,251657,51036,4390402,46.0,5.4
Tender_7365,9133563,118453,345530,746034,380616,10724196,51.0,4.9
Tender_7366,5438843,4956024,2714253,188516,326502,13624138,40.67,5.93
Tender_7367,3225000,1048127,477986,270679,401439,5423231,31.0,6.9
Tender_7368,9914450,501860,2290355,897557,283779,13888001,50.33,4.97
Tender_7369,8684558,1411555,1187861,356977,474015,12114966,45.67,5.43
Tender_7370,5454483,1913049,2873983,240638,187965,10670118,44.33,5.57
Tender_7371,1213770,765299,675009,921741,287271,3863090,23.33,7.67
Tender_7372,7757715,4945204,1560693,687077,266028,15216717,42.33,5.77
Tender_7373,7544490,2123397,2688519,107989,221374,12685769,27.33,7.27
Tender_7374,854130,3813337,824559,68772,122477,5683275,27.67,7.23
Tender_7375,2548013,4974864,1828503,52655,325423,9729458,32.0,6.8
Tender_7376,3761082,4333629,1216894,774936,259001,10345542,45.67,5.43
Tender_7377,7455445,620316,131660,317033,340839,8865293,39.0,6.1
Tender_7378,9245655,2369949,1370390,567115,159651,13712760,40.33,5.97
Tender_7379,1697952,2348709,355943,490295,408705,5301604,26.33,7.37
Tender_7380,1096666,3483237,2085690,837692,336037,7839322,40.33,5.97
Tender_7381,4549289,117460,2627997,469073,185946,7949765,39.0,6.1
Tender_7382,7292627,145550,1445424,695033,155870,9734504,38.33,6.17
Tender_7383,4082641,4242903,2223101,735796,133022,11417463,25.0,7.5
Tender_7384,6696198,4924398,2412980,317368,193609,14544553,47.0,5.3
Tender_7385,4300996,780266,617767,381469,300967,6381465,36.33,6.37
Tender_7386,2573343,2218359,340976,681347,473494,6287519,30.67,6.93
Tender_7387,520032,1531097,2609730,882587,385915,5929361,34.33,6.57
Tender_7388,1672866,1909318,474453,214341,466270,4737248,46.0,5.4
Tender_7389,5979299,2871131,2697082,987061,271355,12805928,39.67,6.03
Tender_7390,5219679,1436000,2040496,504227,97585,9297987,40.67,5.93
Tender_7391,6502026,604230,1587004,578060,85318,9356638,47.67,5.23
Tender_7392,1395654,1585145,2477785,77510,212828,5748922,43.67,5.63
Tender_7393,2391536,4173911,1552313,619781,168736,8906277,17.0,8.3
Tender_7394,1420260,1865215,672375,841896,188041,4987787,36.67,6.33
Tender_7395,4494335,555942,502267,901476,165930,6619950,39.33,6.07
Tender_7396,1726016,2690185,1231008,537048,317947,6502204,33.33,6.67
Tender_7397,3148149,4944693,1692881,931257,165126,10882106,33.33,6.67
Tender_7398,3252289,4855143,683662,895146,174730,9860970,47.33,5.27
Tender_7399,9201992,4210618,265737,290503,245065,14213915,45.67,5.43
Tender_7400,7158039,4542693,2599502,93122,63777,14457133,47.67,5.23
Tender_7401,7690505,385520,2137947,804464,263512,11281948,33.33,6.67
Tender_7402,3375576,2853031,1489171,648372,324997,8691147,41.67,5.83
Tender_7403,1943229,2809654,2700042,99130,347977,7900032,44.0,5.6
Tender_7404,4564709,491457,2584327,651179,301596,8593268,41.0,5.9
Tender_7405,2224563,993498,478262,707856,403841,4808020,30.0,7.0
Tender_7406,9879146,2593940,1913897,392060,393908,15172951,41.67,5.83
Tender_7407,4494109,2431871,2048656,222584,197336,9394556,29.0,7.1
Tender_7408,9832218,1939010,1763202,275980,204733,14015143,59.33,4.07
Tender_7409,2700753,130692,1811950,960214,403227,6006836,54.33,4.57
Tender_7410,7167741,925269,1353915,280393,182552,9909870,34.0,6.6
Tender_7411,5551781,975729,2939708,450542,272269,10190029,34.33,6.57
Tender_7412,1938462,662333,208156,248613,486383,3543947,20.67,7.93
Tender_7413,2181460,3702295,267912,881229,343662,7376558,28.67,7.13
Tender_7414,9118177,4182112,1913679,171160,400871,15785999,25.67,7.43
Tender_7415,5755523,333134,595821,317207,452811,7454496,44.33,5.57
Tender_7416,8654587,2995675,179315,401975,289908,12521460,47.0,5.3
Tender_7417,1131850,982000,927233,333720,114976,3489779,42.0,5.8
Tender_7418,3170766,1251972,751206,713112,285180,6172236,39.67,6.03
Tender_7419,305395,716442,690240,482796,194827,2389700,39.67,6.03
Tender_7420,3238995,579753,1486154,139567,367712,5812181,27.33,7.27
Tender_7421,3765971,4077454,2310234,430046,53997,10637702,53.0,4.7
Tender_7422,1746008,2729796,1602951,239246,372180,6690181,19.67,8.03
Tender_7423,5637761,2157904,1922267,240719,402024,10360675,49.67,5.03
Tender_7424,2991745,2797383,696675,792157,220458,7498418,39.33,6.07
Tender_7425,1903031,1756852,2281096,413345,498528,6852852,39.33,6.07
Tender_7426,9359078,3072529,707578,442125,215382,13796692,21.67,7.83
Tender_7427,419506,2562119,2206816,942084,132973,6263498,38.33,6.17
Tender_7428,9752529,1506914,1392160,388251,371081,13410935,36.33,6.37
Tender_7429,7091821,2164506,2791251,157074,454234,12658886,41.33,5.87
Tender_7430,1371725,3680008,2634018,937619,334820,8958190,42.67,5.73
Tender_7431,2819587,3205616,2087766,659886,53283,8826138,35.33,6.47
Tender_7432,5408915,1864909,481178,734368,285734,8775104,27.33,7.27
Tender_7433,2789542,4117790,641205,460928,97977,8107442,45.0,5.5
Tender_7434,1236143,3017795,532950,571254,306013,5664155,47.0,5.3
Tender_7435,2082365,3224997,1464979,379777,375360,7527478,50.33,4.97
Tender_7436,9416691,4566485,2018068,563722,271310,16836276,33.67,6.63
Tender_7437,5191823,2321673,2277484,567494,419615,10778089,29.33,7.07
Tender_7438,4082411,904444,1529157,500361,239913,7256286,28.0,7.2
Tender_7439,5645013,1152283,1608832,135357,157443,8698928,41.33,5.87
Tender_7440,8162247,4711293,263191,507830,144758,13789319,38.67,6.13
Tender_7441,3968255,1604002,2727051,329792,83752,8712852,43.0,5.7
Tender_7442,401654,3320293,1329695,808911,279772,6140325,29.33,7.07
Tender_7443,8936407,2701118,2263132,850516,385484,15136657,41.33,5.87
Tender_7444,1105355,1639553,1703192,840294,51701,5340095,37.33,6.27
Tender_7445,7075897,2661200,2352269,983870,359109,13432345,37.0,6.3
Tender_7446,5558211,4860070,270834,574581,110174,11373870,41.33,5.87
Tender_7447,8099448,784719,1268726,112272,106766,10371931,41.0,5.9
Tender_7448,2645892,2355780,2635082,862922,309055,8808731,31.67,6.83
Tender_7449,8298383,4429227,2337566,338295,461060,15864531,40.33,5.97
Tender_7450,3363007,2903037,1955225,220992,297896,8740157,34.33,6.57
Tender_7451,8919001,3443876,1477629,854880,389711,15085097,37.33,6.27
Tender_7452,1001077,1060188,150929,987308,336440,3535942,39.67,6.03
Tender_7453,1934858,4354705,2600714,719677,263363,9873317,34.33,6.57
Tender_7454,7182983,2570348,1269333,930371,441829,12394864,56.0,4.4
Tender_7455,5875656,3499866,601132,171734,495446,10643834,46.0,5.4
Tender_7456,9471975,2804114,2970924,868062,401633,16516708,44.0,5.6
Tender_7457,5345036,4570940,504167,61207,201399,10682749,39.0,6.1
Tender_7458,6263873,2937957,1666440,69491,366243,11304004,41.33,5.87
Tender_7459,7220985,2233347,2953936,707053,487075,13602396,32.67,6.73
Tender_7460,3459322,3792414,2478640,854150,412518,10997044,40.0,6.0
Tender_7461,3259125,1970278,776839,59020,426415,6491677,38.33,6.17
Tender_7462,4404430,4726128,349573,999668,256793,10736592,34.0,6.6
Tender_7463,6005894,4864349,1962448,498895,212811,13544397,23.67,7.63
Tender_7464,5034859,2130691,2029290,953454,433038,10581332,38.67,6.13
Tender_7465,315746,227593,1667221,181367,248813,2640740,45.0,5.5
Tender_7466,6230535,802668,1946790,179679,437283,9596955,44.33,5.57
Tender_7467,3995976,3672798,2577668,779392,220685,11246519,56.0,4.4
Tender_7468,7449840,1097489,1896246,995009,323680,11762264,54.67,4.53
Tender_7469,212726,1597735,2108045,625395,397329,4941230,49.0,5.1
Tender_7470,6906895,4039545,400039,230594,319017,11896090,42.67,5.73
Tender_7471,5689518,1292206,2078542,270755,371872,9702893,38.67,6.13
Tender_7472,7280915,2600409,1429626,862608,460025,12633583,49.67,5.03
Tender_7473,8699166,1615127,2576776,436727,428586,13756382,44.67,5.53
Tender_7474,1881857,3271621,1043005,602639,208468,7007590,52.0,4.8
Tender_7475,5583627,1186584,187189,496458,366816,7820674,37.0,6.3
Tender_7476,4575965,4422630,2888336,263929,124256,12275116,31.0,6.9
Tender_7477,339786,767626,166702,464930,89177,1828221,25.0,7.5
Tender_7478,8933981,653868,1652816,300609,403239,11944513,32.0,6.8
Tender_7479,6316066,2788973,553819,818557,213550,10690965,30.33,6.97
Tender_7480,2844932,264739,2717875,621204,309453,6758203,38.33,6.17
Tender_7481,1818282,3868186,1961737,516136,245582,8409923,34.33,6.57
Tender_7482,7753770,1109270,2136962,629340,332459,11961801,33.67,6.63
Tender_7483,8126474,3623215,2300039,651629,218144,14919501,50.33,4.97
Tender_7484,3252086,4559129,2760149,263518,282828,11117710,16.33,8.37
Tender_7485,9697364,4856120,2607113,140607,80786,17381990,39.33,6.07
Tender_7486,7525844,1163685,1228007,724958,472114,11114608,50.33,4.97
Tender_7487,2383045,1833737,1332399,330934,431390,6311505,49.67,5.03
Tender_7488,2700010,1315824,1120452,789416,181830,6107532,34.33,6.57
Tender_7489,9902546,1089791,1596771,596076,65113,13250297,35.0,6.5
Tender_7490,3316994,4181441,416052,898138,351844,9164469,46.67,5.33
Tender_7491,4005665,1037775,2831096,983427,453184,9311147,29.67,7.03
Tender_7492,4950585,808073,2750080,680225,361931,9550894,32.33,6.77
Tender_7493,7114123,2441002,2069934,113367,399481,12137907,31.0,6.9
Tender_7494,8263836,3278018,202739,366891,438574,12550058,58.0,4.2
Tender_7495,1997381,3996055,971054,342863,431272,7738625,46.0,5.4
Tender_7496,9249151,2755730,306497,643977,133131,13088486,21.67,7.83
Tender_7497,5247363,1856310,899411,857207,257862,9118153,36.0,6.4
Tender_7498,4766139,374261,1687990,406276,194416,7429082,46.67,5.33
Tender_7499,7194758,865551,2190012,240746,385106,10876173,49.0,5.1
Tender_7500,1445692,2739018,2087599,480818,159908,6913035,42.67,5.73
Tender_7501,7583968,4183324,984944,447166,497060,13696462,47.67,5.23
Tender_7502,3381351,575472,1076950,458940,258857,5751570,27.0,7.3
Tender_7503,2554238,2869513,2552431,939797,373439,9289418,34.67,6.53
Tender_7504,7792889,3079268,368727,339928,392022,11972834,37.67,6.23
Tender_7505,5193421,3860047,498065,434722,69118,10055373,38.67,6.13
Tender_7506,4280112,406146,1444501,540044,117486,6788289,50.33,4.97
Tender_7507,625024,963465,2377792,110395,425511,4502187,40.0,6.0
Tender_7508,7649100,2409331,1109096,743573,244581,12155681,32.0,6.8
Tender_7509,6816328,2154988,902902,941052,469376,11284646,49.33,5.07
Tender_7510,6642258,288013,232814,978610,467549,8609244,34.67,6.53
Tender_7511,7684794,1325666,528697,208810,320574,10068541,30.33,6.97
Tender_7512,4429604,3814685,1018049,982149,213955,10458442,44.0,5.6
Tender_7513,288924,3382548,313695,778334,457651,5221152,35.33,6.47
Tender_7514,416068,3895052,1073473,880584,222370,6487547,50.0,5.0
Tender_7515,1869834,4887383,1223172,478588,447594,8906571,45.67,5.43
Tender_7516,8908891,1148481,2369022,981740,144732,13552866,53.33,4.67
Tender_7517,5231728,4391672,2052105,740434,234166,12650105,24.0,7.6
Tender_7518,7988239,1165457,1246874,939637,82811,11423018,40.0,6.0
Tender_7519,7355908,2400910,806928,682196,265977,11511919,26.67,7.33
Tender_7520,6670382,2402765,597850,175121,111558,9957676,37.0,6.3
Tender_7521,6334914,167317,2118025,987537,125478,9733271,48.67,5.13
Tender_7522,3405543,2453104,1192760,376032,479721,7907160,45.33,5.47
Tender_7523,5978158,1285817,2498520,988990,355136,11106621,38.0,6.2
Tender_7524,9793899,4564783,2600469,584449,489497,18033097,24.67,7.53
Tender_7525,6504249,1988270,953745,764729,217974,10428967,29.33,7.07
Tender_7526,593967,1178048,1422230,61132,198107,3453484,47.67,5.23
Tender_7527,7644874,2225648,658345,319813,64725,10913405,30.67,6.93
Tender_7528,1667566,1518350,1311737,95750,96464,4689867,35.67,6.43
Tender_7529,2645426,318330,541416,439987,286702,4231861,40.33,5.97
Tender_7530,4791582,445918,1267375,325844,368408,7199127,41.67,5.83
Tender_7531,1096729,2874373,1005032,157194,419170,5552498,41.0,5.9
Tender_7532,9427680,2331421,2521627,209429,243681,14733838,36.67,6.33
Tender_7533,4415812,784165,2245658,558250,239734,8243619,34.33,6.57
Tender_7534,8164345,426052,1184825,283126,347386,10405734,36.0,6.4
Tender_7535,6619209,4361491,129977,267633,323267,11701577,36.67,6.33
Tender_7536,6217434,2566083,538418,350842,482785,10155562,36.0,6.4
Tender_7537,2792921,1159944,152851,434549,384997,4925262,30.67,6.93
Tender_7538,685661,4026874,1329282,99454,437957,6579228,45.33,5.47
Tender_7539,6023356,3508477,2882243,798372,367678,13580126,26.0,7.4
Tender_7540,6600945,4074825,2396672,858674,344661,14275777,39.67,6.03
Tender_7541,3121467,3386981,2233249,776432,175525,9693654,40.33,5.97
Tender_7542,3294085,2584714,92470,430110,183670,6585049,34.33,6.57
Tender_7543,5196950,1269141,1946467,996248,151215,9560021,39.0,6.1
Tender_7544,7818399,3547000,1330818,451346,301561,13449124,51.33,4.87
Tender_7545,2296911,2190232,1176959,785392,73260,6522754,30.33,6.97
Tender_7546,9134505,2017982,2273457,247457,139511,13812912,50.67,4.93
Tender_7547,1193631,1856904,2148228,428166,200545,5827474,40.67,5.93
Tender_7548,3345790,1129479,281201,277736,85889,5120095,27.0,7.3
Tender_7549,8852607,1797698,519056,861948,73430,12104739,49.0,5.1
Tender_7550,9055824,1423852,2614692,728310,233856,14056534,28.67,7.13
Tender_7551,1380011,3092550,802166,605782,138465,6018974,25.33,7.47
Tender_7552,5080542,3585828,1980328,359905,315610,11322213,29.33,7.07
Tender_7553,4214306,1621489,1823062,936847,174465,8770169,28.67,7.13
Tender_7554,7855086,812948,1024529,550197,241140,10483900,55.33,4.47
Tender_7555,1932203,1553484,1935659,969840,371451,6762637,42.0,5.8
Tender_7556,1209361,4003977,2691744,905428,266881,9077391,34.67,6.53
Tender_7557,5007946,2403721,2158981,485576,428522,10484746,52.33,4.77
Tender_7558,5518713,794648,1688758,230765,177081,8409965,48.67,5.13
Tender_7559,8975477,2705454,774956,273393,156028,12885308,38.67,6.13
Tender_7560,3338571,213825,2368811,460598,81062,6462867,54.0,4.6
Tender_7561,6572714,2889024,705394,198097,75103,10440332,35.0,6.5
Tender_7562,1206135,3193413,1380388,210825,460535,6451296,37.0,6.3
Tender_7563,6946136,947625,172177,596344,170616,8832898,29.0,7.1
Tender_7564,800628,3741109,2714565,587840,494956,8339098,29.0,7.1
Tender_7565,638849,1179307,2612144,208828,281160,4920288,26.67,7.33
Tender_7566,7831007,4028722,2681957,768297,187742,15497725,57.33,4.27
Tender_7567,5491385,4018864,2622384,697800,111779,12942212,46.33,5.37
Tender_7568,1122453,1372015,1300700,444754,311614,4551536,37.33,6.27
Tender_7569,7912098,677053,624695,734958,141908,10090712,29.0,7.1
Tender_7570,9896233,3495127,1187773,110030,478779,15167942,41.0,5.9
Tender_7571,7817414,1137711,2905677,536855,301059,12698716,35.33,6.47
Tender_7572,5838693,3629663,341084,178550,90088,10078078,16.0,8.4
Tender_7573,2631279,1948381,1332302,291764,181417,6385143,31.0,6.9
Tender_7574,2899948,2439764,1540367,383653,496520,7760252,40.67,5.93
Tender_7575,1442203,4927085,812641,916929,448172,8547030,22.0,7.8
Tender_7576,7845316,3605295,2495669,544679,302205,14793164,40.0,6.0
Tender_7577,8696433,831785,2440251,676970,291186,12936625,25.33,7.47
Tender_7578,349752,3965222,2516443,740151,338417,7909985,31.33,6.87
Tender_7579,7124466,2688765,2904278,940195,65140,13722844,45.33,5.47
Tender_7580,7069545,3421852,2680990,451132,373603,13997122,43.67,5.63
Tender_7581,8485003,2215434,2497786,478707,255190,13932120,43.67,5.63
Tender_7582,7647244,4693311,400536,679709,56379,13477179,46.67,5.33
Tender_7583,5305197,3886884,1118398,825756,147578,11283813,37.0,6.3
Tender_7584,8603487,4324242,837900,691273,415932,14872834,42.33,5.77
Tender_7585,1378650,1665311,82093,361264,455216,3942534,25.33,7.47
Tender_7586,8782534,572467,303587,308001,75945,10042534,36.0,6.4
Tender_7587,9900070,4064018,1180020,390967,89245,15624320,20.0,8.0
Tender_7588,3556181,2876880,2793591,461476,236730,9924858,52.67,4.73
Tender_7589,389871,1353482,179616,684093,343689,2950751,27.33,7.27
Tender_7590,1325933,599493,1759770,869265,107331,4661792,48.33,5.17
Tender_7591,6891126,4282433,837611,424989,457729,12893888,42.33,5.77
Tender_7592,3603280,2938590,2239755,986935,147443,9916003,30.33,6.97
Tender_7593,7427694,4063090,2340179,977291,381161,15189415,30.33,6.97
Tender_7594,8627295,256730,1796748,773277,320415,11774465,33.33,6.67
Tender_7595,4756327,2330052,2791492,739596,474764,11092231,52.67,4.73
Tender_7596,2303924,3323961,2528054,156451,296856,8609246,41.33,5.87
Tender_7597,7320320,2407087,2935851,883756,77346,13624360,47.33,5.27
Tender_7598,4250061,4565880,2170016,290230,203776,11479963,52.67,4.73
Tender_7599,3754194,1794467,1342905,663495,283881,7838942,43.33,5.67
Tender_7600,7532591,3974966,1901080,362464,352808,14123909,32.67,6.73
Tender_7601,1576248,774294,1394878,538418,419446,4703284,28.33,7.17
Tender_7602,9379080,2767907,2462966,386920,405106,15401979,25.0,7.5
Tender_7603,1788117,1863510,1484202,673282,150177,5959288,26.0,7.4
Tender_7604,4194032,607688,416001,370274,117070,5705065,26.67,7.33
Tender_7605,5513353,1716121,2197974,291373,61009,9779830,45.33,5.47
Tender_7606,5915751,4183025,1701955,334972,414343,12550046,51.67,4.83
Tender_7607,7506985,3604673,1473134,691350,58287,13334429,41.67,5.83
Tender_7608,6304011,1695958,1636878,455474,496376,10588697,45.67,5.43
Tender_7609,7871895,1041208,510633,523113,118933,10065782,36.0,6.4
Tender_7610,2920326,4184756,1108691,532044,434813,9180630,29.33,7.07
Tender_7611,8007617,2430751,140800,871933,197246,11648347,20.67,7.93
Tender_7612,2628000,4341017,842224,638844,131463,8581548,42.0,5.8
Tender_7613,9427372,977778,1418482,545537,273757,12642926,27.33,7.27
Tender_7614,8461862,3524326,1191739,723829,383179,14284935,34.67,6.53
Tender_7615,9463697,3945776,2774965,288289,460564,16933291,25.0,7.5
Tender_7616,2085780,2218361,1153851,528680,455626,6442298,34.33,6.57
Tender_7617,8658670,1994068,154873,120467,417414,11345492,26.0,7.4
Tender_7618,4488516,966827,1747519,747960,157698,8108520,38.0,6.2
Tender_7619,2119570,1322957,164894,431667,257012,4296100,43.67,5.63
Tender_7620,5304833,1116093,136340,242300,178635,6978201,40.0,6.0
Tender_7621,7984027,4640757,1463117,791822,144613,15024336,45.0,5.5
Tender_7622,6576004,1612104,941438,574084,258814,9962444,41.67,5.83
Tender_7623,3302146,3955888,820431,256604,87471,8422540,35.67,6.43
Tender_7624,4179505,1375267,1545122,283444,320481,7703819,52.33,4.77
Tender_7625,8745212,3029562,2388396,109338,196121,14468629,32.67,6.73
Tender_7626,818154,4834636,2530807,733382,291291,9208270,51.67,4.83
Tender_7627,2847639,3609028,2020622,826871,278781,9582941,46.0,5.4
Tender_7628,6793911,3913275,1294133,103975,442614,12547908,32.0,6.8
Tender_7629,8392289,1968516,2300016,891838,459636,14012295,43.0,5.7
Tender_7630,1172277,2589425,1726510,498901,55498,6042611,51.0,4.9
Tender_7631,5055439,4276330,2665439,195346,249896,12442450,19.33,8.07
Tender_7632,7031478,2761395,2122316,963032,362230,13240451,34.0,6.6
Tender_7633,1369076,1700209,337668,923989,469297,4800239,30.33,6.97
Tender_7634,9547971,977469,729527,551099,395171,12201237,30.33,6.97
Tender_7635,7344308,4118743,355694,511493,175478,12505716,34.33,6.57
Tender_7636,7955060,4814063,80782,199448,310217,13359570,40.0,6.0
Tender_7637,8318233,2565838,1802426,715183,103671,13505351,38.33,6.17
Tender_7638,1671085,784892,2664995,533199,412301,6066472,47.67,5.23
Tender_7639,7029696,3666045,2268456,142108,427831,13534136,30.33,6.97
Tender_7640,4871725,2197608,932999,116573,399484,8518389,39.33,6.07
Tender_7641,1418810,3969526,1596691,711225,138602,7834854,36.33,6.37
Tender_7642,8906832,2938984,2000874,307919,103861,14258470,30.67,6.93
Tender_7643,2275260,3256213,1949126,391276,337010,8208885,24.33,7.57
Tender_7644,4608712,295113,1076084,717502,165673,6863084,37.67,6.23
Tender_7645,7245966,1007770,2516290,469252,494639,11733917,37.33,6.27
Tender_7646,1071560,2872050,1888434,671577,216363,6719984,44.0,5.6
Tender_7647,4487938,4028078,2377079,881295,461985,12236375,48.0,5.2
Tender_7648,9864388,3183440,932983,340505,431413,14752729,49.0,5.1
Tender_7649,9907704,2419647,2686105,921592,453572,16388620,41.0,5.9
Tender_7650,1660421,977297,1137927,559610,434992,4770247,25.67,7.43
Tender_7651,2739425,3232266,405451,783929,156580,7317651,41.67,5.83
Tender_7652,3927906,3910368,828348,814920,333058,9814600,39.67,6.03
Tender_7653,7401001,3698233,2696998,120550,196118,14112900,42.67,5.73
Tender_7654,3556786,1107195,1914857,227027,109907,6915772,37.33,6.27
Tender_7655,2635157,2289303,268661,504259,141262,5838642,43.0,5.7
Tender_7656,2668361,1373727,2231889,558862,280457,7113296,27.0,7.3
Tender_7657,8902278,4791617,2691045,284683,165533,16835156,34.67,6.53
Tender_7658,695299,1639932,1067260,491835,113814,4008140,53.67,4.63
Tender_7659,3007075,2037265,1276882,400257,63863,6785342,26.67,7.33
Tender_7660,7714965,2406750,1533869,107662,267223,12030469,37.0,6.3
Tender_7661,8766919,1253631,2050682,543151,440252,13054635,28.67,7.13
Tender_7662,276487,4690087,939196,827800,151618,6885188,34.33,6.57
Tender_7663,1426189,1519132,80072,267932,344381,3637706,20.33,7.97
Tender_7664,3764913,601310,1928046,974204,99201,7367674,37.33,6.27
Tender_7665,5188366,3771853,484052,304329,451477,10200077,47.33,5.27
Tender_7666,8349987,4518539,488260,174624,223093,13754503,27.67,7.23
Tender_7667,2731328,4317487,294028,759769,115435,8218047,45.67,5.43
Tender_7668,910362,3645642,708027,315081,321468,5900580,38.67,6.13
Tender_7669,9675572,1149481,1424652,974360,457633,13681698,53.0,4.7
Tender_7670,7481114,1391965,2985839,79121,53598,11991637,21.67,7.83
Tender_7671,8421363,2186624,657961,548664,421674,12236286,36.33,6.37
Tender_7672,4301499,2832411,2871752,319426,453758,10778846,29.33,7.07
Tender_7673,9229878,2029963,2560016,684784,483300,14987941,53.0,4.7
Tender_7674,7279437,2426499,1687381,853843,195704,12442864,44.0,5.6
Tender_7675,6698271,1606769,1489080,58294,358619,10211033,40.0,6.0
Tender_7676,8300290,1357143,1936435,56672,404698,12055238,20.0,8.0
Tender_7677,5985697,1100686,2863313,496907,479494,10926097,38.67,6.13
Tender_7678,1332689,1968843,968013,579638,276034,5125217,34.33,6.57
Tender_7679,7432591,1407683,2404747,311765,163069,11719855,26.33,7.37
Tender_7680,6480947,4773153,1927536,753333,297966,14232935,44.67,5.53
Tender_7681,3719959,3614833,1028806,220428,301962,8885988,47.67,5.23
Tender_7682,7642587,4589588,2877339,507401,71689,15688604,34.33,6.57
Tender_7683,6708255,4238916,869277,201802,399479,12417729,43.0,5.7
Tender_7684,7872953,4275330,1296491,95742,138258,13678774,37.0,6.3
Tender_7685,621949,1933066,353531,235358,310657,3454561,43.67,5.63
Tender_7686,4265583,1476538,1933583,745200,74734,8495638,55.0,4.5
Tender_7687,3103911,2849965,2918318,163645,65333,9101172,32.67,6.73
Tender_7688,8269378,4865034,702523,808263,381464,15026662,23.0,7.7
Tender_7689,5261619,4807499,88068,225813,141581,10524580,34.67,6.53
Tender_7690,1639805,3354890,1532323,281779,111657,6920454,42.0,5.8
Tender_7691,5181375,533709,217426,73577,456172,6462259,40.0,6.0
Tender_7692,4087595,4938538,1118386,660703,480653,11285875,58.67,4.13
Tender_7693,9335471,2138124,1644043,63051,52740,13233429,36.67,6.33
Tender_7694,4173548,2461443,1577818,968316,64474,9245599,57.0,4.3
Tender_7695,7622546,4246071,1906895,604644,396302,14776458,30.33,6.97
Tender_7696,5556132,3093024,2341523,496985,443269,11930933,35.33,6.47
Tender_7697,214440,4686741,1196054,166047,228650,6491932,44.33,5.57
Tender_7698,5950959,3230906,1670226,215988,337826,11405905,25.33,7.47
Tender_7699,3882476,4351561,1695989,67398,65838,10063262,27.67,7.23
Tender_7700,433318,2152958,1637518,578286,356145,5158225,50.67,4.93
Tender_7701,9434616,2635345,653816,621424,368494,13713695,34.0,6.6
Tender_7702,3421414,2283079,1897889,410435,476041,8488858,20.0,8.0
Tender_7703,3767605,2102379,482005,638493,328208,7318690,33.0,6.7
Tender_7704,6505020,1376703,908157,271557,431399,9492836,44.0,5.6
Tender_7705,820455,4423671,317211,114561,139416,5815314,37.33,6.27
Tender_7706,1926073,466469,618670,451615,253815,3716642,32.67,6.73
Tender_7707,5115913,935313,2992093,842595,439510,10325424,43.33,5.67
Tender_7708,7404492,2248658,1230793,955143,135673,11974759,36.0,6.4
Tender_7709,8417550,217393,248801,395307,274405,9553456,53.33,4.67
Tender_7710,2076513,2468802,503871,462950,263481,5775617,24.0,7.6
Tender_7711,6079592,3164716,1011934,753482,444374,11454098,19.33,8.07
Tender_7712,1470700,718199,816722,942542,214284,4162447,25.67,7.43
Tender_7713,1590329,3784351,1713492,298365,267921,7654458,34.67,6.53
Tender_7714,9257200,3907019,1494135,291429,492063,15441846,41.33,5.87
Tender_7715,9611352,293419,1078690,779135,341091,12103687,43.33,5.67
Tender_7716,8860725,1010622,1918863,939022,68451,12797683,44.33,5.57
Tender_7717,9535342,4204553,1038236,433781,199271,15411183,26.67,7.33
Tender_7718,3287327,723835,998509,260709,126015,5396395,42.0,5.8
Tender_7719,8387932,3011596,2420623,449829,335617,14605597,33.67,6.63
Tender_7720,1079825,2475388,1934174,603655,237687,6330729,58.67,4.13
Tender_7721,4240554,4315260,2290856,957101,56534,11860305,35.33,6.47
Tender_7722,2870802,2296835,1590542,433487,155541,7347207,37.33,6.27
Tender_7723,3047606,4851180,263089,786974,329504,9278353,32.67,6.73
Tender_7724,5177174,2781595,1090513,258684,334327,9642293,40.67,5.93
Tender_7725,8684757,553608,1891911,94186,434617,11659079,45.33,5.47
Tender_7726,1279922,3229022,1569341,726528,243374,7048187,40.67,5.93
Tender_7727,4170602,2195384,807489,192404,463069,7828948,38.0,6.2
Tender_7728,6518331,3331209,1062264,747256,167864,11826924,42.0,5.8
Tender_7729,854209,1159066,1073605,322139,277850,3686869,26.67,7.33
Tender_7730,5328978,2103333,1515967,130444,297334,9376056,36.0,6.4
Tender_7731,3476151,3717046,1608349,783394,466857,10051797,30.67,6.93
Tender_7732,7735441,215827,2800418,782788,87137,11621611,37.33,6.27
Tender_7733,4691670,3805694,1148842,614923,289078,10550207,45.33,5.47
Tender_7734,5976707,3596465,2671337,503097,254264,13001870,36.67,6.33
Tender_7735,6393615,4760654,2608572,876957,216952,14856750,27.67,7.23
Tender_7736,7733789,1461816,2814801,380743,160535,12551684,29.33,7.07
Tender_7737,6828219,3729616,823918,565783,483256,12430792,37.33,6.27
Tender_7738,7519830,2012148,224293,195555,192462,10144288,36.33,6.37
Tender_7739,4348755,3835439,2202538,279449,298948,10965129,28.0,7.2
Tender_7740,9758045,2478638,1643924,502563,169537,14552707,32.67,6.73
Tender_7741,5288744,257234,1994939,357402,321217,8219536,27.67,7.23
Tender_7742,498943,3302295,1424792,923582,177569,6327181,47.67,5.23
Tender_7743,9194717,4312844,196275,53572,241077,13998485,27.67,7.23
Tender_7744,1628061,2828359,542064,257863,143149,5399496,25.33,7.47
Tender_7745,9780423,4881612,2595086,74841,393633,17725595,54.0,4.6
Tender_7746,2385624,3765864,1050957,809731,105509,8117685,29.67,7.03
Tender_7747,8534775,2200285,870854,452453,446273,12504640,39.67,6.03
Tender_7748,5762413,3569415,2727014,565647,492390,13116879,21.33,7.87
Tender_7749,8704811,3161260,1323838,386850,205021,13781780,29.67,7.03
Tender_7750,4798171,1257337,1325230,112841,383480,7877059,34.0,6.6
Tender_7751,8940781,661201,953387,699172,85046,11339587,41.0,5.9
Tender_7752,2835636,2855905,2871532,833419,492870,9889362,24.67,7.53
Tender_7753,8399167,4159296,1854520,678141,325859,15416983,44.33,5.57
Tender_7754,7593877,1328748,1603014,834471,386053,11746163,34.0,6.6
Tender_7755,6388953,2520308,2945160,150409,66400,12071230,20.67,7.93
Tender_7756,5289181,4611200,2409451,640719,466155,13416706,47.33,5.27
Tender_7757,7779256,2880079,517382,782556,393931,12353204,48.33,5.17
Tender_7758,3320285,3295172,1413908,524202,483252,9036819,38.0,6.2
Tender_7759,3066529,3399885,974425,398091,185764,8024694,37.33,6.27
Tender_7760,7989412,2828636,706805,916239,412928,12854020,29.0,7.1
Tender_7761,1075425,2456970,2134549,383911,465314,6516169,36.33,6.37
Tender_7762,1594017,3641553,1817399,382941,292547,7728457,35.67,6.43
Tender_7763,2730580,2460687,903706,735383,105796,6936152,46.67,5.33
Tender_7764,4476930,1902150,2702631,374733,319586,9776030,38.0,6.2
Tender_7765,6497928,4377407,2631807,776730,333566,14617438,26.67,7.33
Tender_7766,7973073,4835763,1395296,750277,170165,15124574,30.33,6.97
Tender_7767,6156145,4035060,1884884,842268,62777,12981134,39.67,6.03
Tender_7768,5479183,1922261,2914295,704629,171994,11192362,36.0,6.4
Tender_7769,8321840,134194,2214512,907499,421514,11999559,33.0,6.7
Tender_7770,6623907,3802003,1522414,938843,411131,13298298,48.67,5.13
Tender_7771,3648576,138768,375089,65587,104202,4332222,41.33,5.87
Tender_7772,4327940,105807,1192818,357031,67621,6051217,37.0,6.3
Tender_7773,8161262,2458908,2778929,562656,105432,14067187,55.33,4.47
Tender_7774,2211568,3432411,613697,452352,91163,6801191,49.67,5.03
Tender_7775,1397565,3535125,946594,860347,459305,7198936,41.33,5.87
Tender_7776,3569607,3599951,2074380,715855,453450,10413243,39.67,6.03
Tender_7777,5554794,597427,273238,502911,486524,7414894,32.33,6.77
Tender_7778,2184467,3134511,1206519,279491,137833,6942821,48.33,5.17
Tender_7779,7981124,1474298,2159700,669141,292712,12576975,59.67,4.03
Tender_7780,715030,1218813,1471520,95721,186711,3687795,31.67,6.83
Tender_7781,9465487,3543721,1602011,426801,309082,15347102,29.67,7.03
Tender_7782,7846597,954266,473294,773449,68230,10115836,37.33,6.27
Tender_7783,2059432,1246163,848764,506075,396514,5056948,35.33,6.47
Tender_7784,7184540,2618184,483881,416214,214820,10917639,28.67,7.13
Tender_7785,5456463,4169751,979871,196804,201882,11004771,34.0,6.6
Tender_7786,1086901,1034085,2270002,658725,79814,5129527,24.67,7.53
Tender_7787,9063259,1739731,1123337,399156,401592,12727075,40.33,5.97
Tender_7788,2042360,282007,977826,987757,365849,4655799,49.67,5.03
Tender_7789,8047631,2871466,1764303,236446,473766,13393612,44.33,5.57
Tender_7790,1030684,1450021,1646443,462198,326098,4915444,34.67,6.53
Tender_7791,3619947,131793,359093,254791,221058,4586682,31.0,6.9
Tender_7792,7572234,3412618,367050,438660,381591,12172153,33.0,6.7
Tender_7793,6834258,2346434,865345,673385,431340,11150762,33.33,6.67
Tender_7794,1345660,318110,1559265,104138,256509,3583682,51.0,4.9
Tender_7795,3839773,4826252,2949581,341389,289883,12246878,51.33,4.87
Tender_7796,5688672,634790,2186065,260545,70619,8840691,36.67,6.33
Tender_7797,2935836,765195,2695118,337162,249218,6982529,46.33,5.37
Tender_7798,5029463,3880055,2332007,188963,435736,11866224,32.67,6.73
Tender_7799,2761378,216309,2362841,80399,147303,5568230,43.33,5.67
Tender_7800,9445263,3441641,1196880,536768,94184,14714736,42.67,5.73
Tender_7801,1926135,3726662,1552178,416004,245169,7866148,47.0,5.3
Tender_7802,7380831,4819419,2119220,516877,182984,15019331,41.0,5.9
Tender_7803,9935960,2018147,2004626,544378,181860,14684971,44.33,5.57
Tender_7804,4816507,2766004,2814045,971358,255745,11623659,24.67,7.53
Tender_7805,5728159,2589620,2869649,462903,489831,12140162,32.67,6.73
Tender_7806,4231909,4378228,1392949,458230,433139,10894455,27.0,7.3
Tender_7807,9324400,995403,154456,126501,203753,10804513,23.67,7.63
Tender_7808,4543585,294209,743513,307893,499909,6389109,41.0,5.9
Tender_7809,5479022,1454813,2691064,51779,452377,10129055,31.33,6.87
Tender_7810,5959204,832271,2541718,286088,300313,9919594,25.33,7.47
Tender_7811,5190969,1126196,1952817,67980,367975,8705937,51.33,4.87
Tender_7812,2921966,2324551,1523885,948364,449772,8168538,39.67,6.03
Tender_7813,7992057,338860,2853562,476679,294547,11955705,43.0,5.7
Tender_7814,2440222,822942,2632441,733268,468011,7096884,28.33,7.17
Tender_7815,4869518,2736443,2663440,56133,259498,10585032,50.33,4.97
Tender_7816,4765748,2725613,2335983,161266,105484,10094094,52.0,4.8
Tender_7817,7547078,4580375,2576776,670721,335769,15710719,43.67,5.63
Tender_7818,6001577,966975,80942,383730,216230,7649454,33.0,6.7
Tender_7819,3602161,3463957,308393,453913,301135,8129559,48.0,5.2
Tender_7820,9505231,4206265,372900,510961,381247,14976604,35.0,6.5
Tender_7821,7711176,1728097,526907,565918,203090,10735188,35.0,6.5
Tender_7822,9975044,4487670,357876,252917,176808,15250315,48.67,5.13
Tender_7823,2430151,1911748,2300327,146461,314573,7103260,45.67,5.43
Tender_7824,765803,2046041,480199,883253,278503,4453799,24.0,7.6
Tender_7825,1706891,3922656,2447416,608785,264624,8950372,51.33,4.87
Tender_7826,4937059,115994,1453623,627444,117128,7251248,43.67,5.63
Tender_7827,8889978,2551093,171639,342322,237755,12192787,31.0,6.9
Tender_7828,2685716,4440560,1568350,200775,76053,8971454,29.33,7.07
Tender_7829,3017213,1734558,767549,867938,139791,6527049,47.0,5.3
Tender_7830,3536533,2779610,2320375,199963,450290,9286771,43.67,5.63
Tender_7831,8306912,3520060,1457389,329192,454516,14068069,28.33,7.17
Tender_7832,3219908,2089723,2394434,567714,312776,8584555,31.33,6.87
Tender_7833,6360042,1646361,2512477,613953,196769,11329602,55.67,4.43
Tender_7834,9808217,4086743,1009855,678707,449742,16033264,51.33,4.87
Tender_7835,6594508,4047021,233232,257135,219276,11351172,50.67,4.93
Tender_7836,9154344,496010,2293204,115125,95586,12154269,33.67,6.63
Tender_7837,7086012,1896045,705184,452525,336256,10476022,61.0,3.9
Tender_7838,5597183,3503103,474378,639970,386133,10600767,36.33,6.37
Tender_7839,339626,684813,98902,757632,447089,2328062,47.33,5.27
Tender_7840,6567100,1949981,1885866,201565,93328,10697840,44.67,5.53
Tender_7841,7204090,1355140,2465814,981376,314400,12320820,31.67,6.83
Tender_7842,628752,4330861,344060,695678,228907,6228258,33.67,6.63
Tender_7843,2224673,4342430,2920992,74395,477798,10040288,32.0,6.8
Tender_7844,1636971,4235324,218236,802712,175772,7069015,39.33,6.07
Tender_7845,6944823,2965117,2172303,409638,319767,12811648,47.67,5.23
Tender_7846,5994437,1249277,2056824,989157,85263,10374958,47.0,5.3
Tender_7847,5849720,2758902,2121467,833590,392624,11956303,36.0,6.4
Tender_7848,9026342,4028180,2514910,442843,143561,16155836,36.67,6.33
Tender_7849,6890539,3683172,2369687,358084,189200,13490682,36.67,6.33
Tender_7850,6136609,4666466,229603,746495,178038,11957211,40.33,5.97
Tender_7851,1787828,4054133,2401086,262012,344367,8849426,34.0,6.6
Tender_7852,1568464,3016683,2146959,592100,410275,7734481,21.0,7.9
Tender_7853,6009368,1616960,1296562,124194,155229,9202313,43.67,5.63
Tender_7854,688582,3504002,1461475,214371,95918,5964348,32.0,6.8
Tender_7855,4190451,2331064,1758747,638201,479846,9398309,39.67,6.03
Tender_7856,5635283,2195193,1070863,815958,104729,9822026,31.0,6.9
Tender_7857,6310176,3770875,1202848,424688,191759,11900346,50.33,4.97
Tender_7858,6407051,4268368,2016774,779676,105909,13577778,24.67,7.53
Tender_7859,9469347,4224675,2699580,618335,51898,17063835,35.33,6.47
Tender_7860,1926687,2926469,2724014,244241,72198,7893609,45.0,5.5
Tender_7861,9323994,1253363,1049854,671400,365004,12663615,42.0,5.8
Tender_7862,1137277,2921570,1916535,332658,411828,6719868,24.0,7.6
Tender_7863,1059791,2650175,751803,271618,230929,4964316,37.67,6.23
Tender_7864,7179330,1194950,2360629,951858,294106,11980873,23.0,7.7
Tender_7865,6908964,939822,1054812,615439,327990,9847027,44.33,5.57
Tender_7866,698913,3962096,305029,89431,133458,5188927,22.67,7.73
Tender_7867,6164236,857900,203892,983207,427288,8636523,20.67,7.93
Tender_7868,7303463,1098604,2454026,64405,354366,11274864,35.0,6.5
Tender_7869,8312859,3585188,931455,242536,495963,13568001,45.0,5.5
Tender_7870,8253951,4510389,207867,958017,190263,14120487,35.0,6.5
Tender_7871,3317026,2337623,1807612,374879,441276,8278416,49.0,5.1
Tender_7872,1960856,2892768,951362,150494,404492,6359972,36.67,6.33
Tender_7873,3350761,4871463,1014906,793769,96644,10127543,40.33,5.97
Tender_7874,7519936,4770587,2389775,227849,412667,15320814,53.0,4.7
Tender_7875,497192,1534682,1623074,474387,491086,4620421,49.0,5.1
Tender_7876,873619,3271044,2685175,829061,465012,8123911,26.67,7.33
Tender_7877,9218737,1927616,487293,914920,475754,13024320,53.67,4.63
Tender_7878,4786563,2702980,1850078,84800,448662,9873083,38.0,6.2
Tender_7879,3787361,2565456,265426,269030,485946,7373219,34.67,6.53
Tender_7880,9258694,2726554,697946,399298,417747,13500239,30.33,6.97
Tender_7881,777241,455550,696034,987995,375053,3291873,44.67,5.53
Tender_7882,608728,2832883,664708,373289,366785,4846393,46.67,5.33
Tender_7883,7331254,1871131,1940272,239751,295781,11678189,26.67,7.33
Tender_7884,4321327,3999323,1191366,387733,262679,10162428,38.67,6.13
Tender_7885,4125387,3162724,2844305,720061,216891,11069368,42.33,5.77
Tender_7886,8488667,2369800,696443,710351,414269,12679530,39.33,6.07
Tender_7887,9085482,4821672,2983628,909671,173323,17973776,35.67,6.43
Tender_7888,2514248,560644,419064,781182,497533,4772671,46.33,5.37
Tender_7889,4290509,2411413,2034048,636122,77641,9449733,46.33,5.37
Tender_7890,7278176,2921967,2371659,426233,394541,13392576,46.33,5.37
Tender_7891,2113648,1100517,2842232,947142,186890,7190429,32.67,6.73
Tender_7892,425162,654287,816041,767869,324811,2988170,36.0,6.4
Tender_7893,8579998,2241090,2969226,963251,135888,14889453,36.67,6.33
Tender_7894,9046910,1044965,2013845,705057,288317,13099094,38.33,6.17
Tender_7895,7798526,186787,1902087,378789,413544,10679733,40.0,6.0
Tender_7896,3033452,759462,355978,586334,121776,4857002,34.33,6.57
Tender_7897,1287703,157169,290781,882463,96979,2715095,55.0,4.5
Tender_7898,9871458,4733668,1542052,90730,226547,16464455,57.33,4.27
Tender_7899,1870060,4581494,2965538,915203,232888,10565183,29.0,7.1
Tender_7900,6632459,3992935,159326,124324,74558,10983602,44.33,5.57
Tender_7901,3520830,1506635,2807558,247769,449016,8531808,40.67,5.93
Tender_7902,311313,3253486,383021,181761,149581,4279162,36.67,6.33
Tender_7903,2047550,4890376,2836562,458794,359450,10592732,25.67,7.43
Tender_7904,7448488,245343,2381569,335987,384347,10795734,48.33,5.17
Tender_7905,5744403,3045147,1018065,362892,277220,10447727,48.0,5.2
Tender_7906,1732312,2678952,758694,558875,417816,6146649,52.33,4.77
Tender_7907,7229512,3871684,1535352,276106,313705,13226359,29.33,7.07
Tender_7908,9319568,914884,1376009,901311,422796,12934568,29.0,7.1
Tender_7909,904448,1780919,430027,663818,64249,3843461,29.33,7.07
Tender_7910,723511,4239746,688772,626071,114823,6392923,50.0,5.0
Tender_7911,4726521,1714279,391234,318926,86720,7237680,33.67,6.63
Tender_7912,8277773,1163129,908443,554159,264552,11168056,47.33,5.27
Tender_7913,3288390,3254337,2896002,82545,341287,9862561,48.0,5.2
Tender_7914,1907108,3307785,2339265,705190,127025,8386373,45.67,5.43
Tender_7915,5680002,3670544,953778,986947,89778,11381049,43.0,5.7
Tender_7916,3540115,3237125,250007,542980,333353,7903580,44.33,5.57
Tender_7917,5744234,4370244,2179555,736624,288052,13318709,30.33,6.97
Tender_7918,8114772,697136,1093163,349213,183243,10437527,32.0,6.8
Tender_7919,735085,4545562,993260,604647,69017,6947571,49.67,5.03
Tender_7920,542168,1780338,2657970,847781,253917,6082174,29.33,7.07
Tender_7921,3685172,4061913,864220,785197,436299,9832801,38.67,6.13
Tender_7922,5742086,135832,950449,480694,185094,7494155,43.0,5.7
Tender_7923,8732856,1699709,1249800,710397,348164,12740926,40.33,5.97
Tender_7924,7748945,4961919,1861889,786018,130929,15489700,29.33,7.07
Tender_7925,1549158,2346661,654444,426932,429948,5407143,37.67,6.23
Tender_7926,8333735,4253686,774799,271984,138499,13772703,37.67,6.23
Tender_7927,1183825,1955722,1765024,984898,70533,5960002,29.0,7.1
Tender_7928,3323589,1012706,1104177,150978,286661,5878111,54.67,4.53
Tender_7929,365974,1654910,644737,232781,180059,3078461,37.0,6.3
Tender_7930,1082677,2862230,1110991,778216,462708,6296822,52.0,4.8
Tender_7931,6094683,2446792,94832,741842,245810,9623959,51.33,4.87
Tender_7932,5696264,4256852,192152,628802,395204,11169274,36.0,6.4
Tender_7933,6320592,483269,2971770,729612,381277,10886520,23.67,7.63
Tender_7934,438259,4257354,492200,436826,244003,5868642,24.67,7.53
Tender_7935,2022067,3041818,2077766,441950,256001,7839602,34.33,6.57
Tender_7936,9319560,901038,1220488,229563,116828,11787477,42.0,5.8
Tender_7937,7768399,2571332,759732,521296,69798,11690557,48.67,5.13
Tender_7938,9075126,4842548,1569606,678966,118776,16285022,36.0,6.4
Tender_7939,9912663,4247308,2638310,917002,409722,18125005,34.67,6.53
Tender_7940,398311,3618461,468237,950801,391735,5827545,35.67,6.43
Tender_7941,1155710,4254100,1230911,681066,116455,7438242,27.0,7.3
Tender_7942,5649844,2698629,2948389,850358,357106,12504326,42.33,5.77
Tender_7943,3341393,603665,1148692,258679,182081,5534510,25.33,7.47
Tender_7944,4620959,581099,2064251,450886,352187,8069382,46.0,5.4
Tender_7945,2624774,1385677,1051714,463691,197984,5723840,49.67,5.03
Tender_7946,3972894,4571571,2353272,239658,488403,11625798,41.0,5.9
Tender_7947,2399167,3501255,891047,411536,244060,7447065,31.0,6.9
Tender_7948,6160619,4172378,982700,366993,100233,11782923,39.0,6.1
Tender_7949,6007778,2197616,941086,578349,151477,9876306,47.67,5.23
Tender_7950,4642423,900644,1727044,728956,381494,8380561,45.67,5.43
Tender_7951,3588795,3582999,2045173,746449,87293,10050709,41.67,5.83
Tender_7952,3502313,350269,218193,982447,364347,5417569,26.0,7.4
Tender_7953,4523171,3902987,1919514,726783,334405,11406860,38.67,6.13
Tender_7954,3070945,2106183,1837944,55327,474715,7545114,27.0,7.3
Tender_7955,3734846,857598,730073,171303,353987,5847807,52.67,4.73
Tender_7956,3121390,4997752,2220856,710687,193897,11244582,47.33,5.27
Tender_7957,1605329,4487214,125262,771772,398499,7388076,28.67,7.13
Tender_7958,3103500,3118353,2910730,107497,384287,9624367,54.33,4.57
Tender_7959,5272383,479854,2543170,288493,396674,8980574,38.33,6.17
Tender_7960,3540375,2361120,2908677,829437,325667,9965276,44.0,5.6
Tender_7961,321887,4094540,2482834,138464,443354,7481079,46.0,5.4
Tender_7962,2566457,4559425,1503418,528753,212073,9370126,34.33,6.57
Tender_7963,5754077,4802657,1759992,768411,445881,13531018,44.67,5.53
Tender_7964,8846249,1278703,129811,313789,302288,10870840,44.67,5.53
Tender_7965,3602847,2938982,1482546,736751,379168,9140294,33.67,6.63
Tender_7966,4329705,3140975,623536,577200,416485,9087901,54.33,4.57
Tender_7967,478420,3333356,1346882,563633,405306,6127597,52.67,4.73
Tender_7968,3858130,3628227,2709882,80455,399328,10676022,20.0,8.0
Tender_7969,6909155,979369,1360072,348175,72044,9668815,17.33,8.27
Tender_7970,1424784,1652404,91048,148216,420649,3737101,38.67,6.13
Tender_7971,4207814,4634797,2404929,875782,296661,12419983,39.67,6.03
Tender_7972,2466302,1495344,2700829,602611,84332,7349418,31.0,6.9
Tender_7973,2543078,2595679,1287727,758142,420031,7604657,34.0,6.6
Tender_7974,8443077,512405,2138739,537292,309613,11941126,29.33,7.07
Tender_7975,7289210,4465481,1909401,818932,176125,14659149,27.0,7.3
Tender_7976,9924703,1348186,2974895,510859,469305,15227948,24.67,7.53
Tender_7977,446048,4754207,506382,621759,59536,6387932,37.33,6.27
Tender_7978,4482536,3891289,124382,945712,399352,9843271,50.33,4.97
Tender_7979,8312333,1213123,205086,449713,145809,10326064,46.0,5.4
Tender_7980,4623227,3805917,651677,307940,95051,9483812,31.67,6.83
Tender_7981,5201338,2532250,1915044,877090,236859,10762581,32.67,6.73
Tender_7982,8529833,417079,1478305,69149,261790,10756156,41.0,5.9
Tender_7983,4058145,3270351,2127264,527599,427905,10411264,32.0,6.8
Tender_7984,400607,2707652,2390095,574301,65719,6138374,31.0,6.9
Tender_7985,8815233,4286060,2589364,118070,104743,15913470,33.33,6.67
Tender_7986,1910029,488464,2298587,599270,157463,5453813,53.0,4.7
Tender_7987,2230275,4568157,1784953,78275,439350,9101010,35.0,6.5
Tender_7988,714490,4512691,2316461,451055,357869,8352566,29.33,7.07
Tender_7989,7663984,3836601,2069857,410348,359440,14340230,52.0,4.8
Tender_7990,9532758,382502,2884231,664847,183774,13648112,31.0,6.9
Tender_7991,423749,2238373,2134802,527980,479778,5804682,44.67,5.53
Tender_7992,9568639,2540410,2336454,291245,440571,15177319,20.33,7.97
Tender_7993,8387602,4902492,552149,278754,297691,14418688,45.0,5.5
Tender_7994,7233122,785027,555689,708858,261988,9544684,43.0,5.7
Tender_7995,6589664,3514795,1869478,605286,227321,12806544,52.33,4.77
Tender_7996,8261272,296134,1229008,852925,369604,11008943,29.0,7.1
Tender_7997,9052659,4143476,2647282,145452,317222,16306091,34.67,6.53
Tender_7998,5316054,1700833,257928,365897,196030,7836742,37.67,6.23
Tender_7999,5896598,245826,576385,742507,233671,7694987,38.0,6.2
Tender_8000,3657553,1362654,1330511,896692,291609,7539019,31.33,6.87
Tender_8001,3522946,4120337,2322419,300518,260130,10526350,42.33,5.77
Tender_8002,5069546,3143010,859994,382177,134129,9588856,25.33,7.47
Tender_8003,3407540,4569944,2188038,999115,85497,11250134,43.0,5.7
Tender_8004,4266926,4268245,2434100,739863,418496,12127630,45.0,5.5
Tender_8005,6082863,2252465,1878582,811169,378267,11403346,29.33,7.07
Tender_8006,7917186,1704383,1640955,674311,72789,12009624,43.0,5.7
Tender_8007,8795638,1298678,1443858,522798,392678,12453650,41.67,5.83
Tender_8008,5185724,188355,856611,260822,215118,6706630,43.67,5.63
Tender_8009,3875958,3102861,2753306,780567,133190,10645882,37.0,6.3
Tender_8010,7843444,489400,1705110,797662,66107,10901723,48.0,5.2
Tender_8011,860929,354569,2792562,264267,277003,4549330,52.67,4.73
Tender_8012,1370811,426389,2030971,412791,331104,4572066,29.33,7.07
Tender_8013,1433924,2338090,1727986,819430,113063,6432493,34.33,6.57
Tender_8014,8713503,1926446,953057,135744,498755,12227505,26.33,7.37
Tender_8015,970045,3367467,258270,134056,56880,4786718,49.0,5.1
Tender_8016,3542117,2918657,1922387,408700,460958,9252819,45.0,5.5
Tender_8017,3518368,3692203,739391,433791,422998,8806751,37.33,6.27
Tender_8018,6889571,116332,2324274,889909,269507,10489593,45.0,5.5
Tender_8019,1601033,4202059,1948048,205150,359121,8315411,42.0,5.8
Tender_8020,3632739,2929615,592238,316267,479756,7950615,25.0,7.5
Tender_8021,6771567,2439598,2002543,142626,270799,11627133,37.0,6.3
Tender_8022,3766200,2994343,1540419,415090,104245,8820297,46.0,5.4
Tender_8023,8266577,2311325,1958000,814834,152109,13502845,44.67,5.53
Tender_8024,5672316,1667371,2712878,555724,338391,10946680,32.67,6.73
Tender_8025,603430,1557329,958468,516996,477528,4113751,60.67,3.93
Tender_8026,7272994,1873661,496619,676128,281750,10601152,48.33,5.17
Tender_8027,568420,1878224,2385303,226910,454453,5513310,30.33,6.97
Tender_8028,5448911,3768144,796222,719799,177932,10911008,44.67,5.53
Tender_8029,1209257,171453,2881428,394601,404944,5061683,38.33,6.17
Tender_8030,3902605,3594538,2643445,618456,428542,11187586,38.67,6.13
Tender_8031,4282389,2200796,499303,708842,392055,8083385,36.33,6.37
Tender_8032,6475258,1714902,882026,790910,200364,10063460,23.33,7.67
Tender_8033,1836071,2597165,361334,381865,167957,5344392,35.33,6.47
Tender_8034,2090040,3819619,989048,276601,219622,7394930,44.33,5.57
Tender_8035,6828520,1223117,1096810,914278,461045,10523770,21.67,7.83
Tender_8036,4164667,3681523,2392711,76557,301195,10616653,54.67,4.53
Tender_8037,8229278,4960341,1640898,651449,497733,15979699,24.0,7.6
Tender_8038,9534437,1935106,300351,912693,90640,12773227,55.67,4.43
Tender_8039,5025854,1420710,1933652,899216,414897,9694329,42.33,5.77
Tender_8040,6137143,969892,2435294,902587,98658,10543574,40.33,5.97
Tender_8041,7766440,2868892,709891,199059,465708,12009990,45.67,5.43
Tender_8042,4142152,1189424,2096580,220775,60819,7709750,50.67,4.93
Tender_8043,7120676,4915746,1238352,507278,426112,14208164,36.67,6.33
Tender_8044,3018163,4953260,1744970,973518,115548,10805459,24.33,7.57
Tender_8045,6092023,3126495,628143,447768,442700,10737129,45.67,5.43
Tender_8046,4245480,4911330,717193,432517,169854,10476374,29.33,7.07
Tender_8047,415188,3425218,738783,722196,213542,5514927,56.0,4.4
Tender_8048,4310640,762486,617655,593318,279725,6563824,49.67,5.03
Tender_8049,4686049,3888107,1422807,186523,290047,10473533,29.67,7.03
Tender_8050,2308215,395095,1181675,835551,410574,5131110,41.0,5.9
Tender_8051,7464153,4365717,1313716,713388,76114,13933088,43.0,5.7
Tender_8052,262514,4493365,1624277,731466,197091,7308713,37.67,6.23
Tender_8053,3032308,3106653,2777138,297291,296374,9509764,38.0,6.2
Tender_8054,7590212,2347035,1084451,991505,428370,12441573,36.0,6.4
Tender_8055,4164109,4658414,2645463,739642,121118,12328746,33.0,6.7
Tender_8056,3329770,1045852,1738662,939694,398375,7452353,38.33,6.17
Tender_8057,2353807,4795660,2804818,577884,349937,10882106,41.67,5.83
Tender_8058,6935301,4385652,869882,168764,76353,12435952,26.0,7.4
Tender_8059,2391097,1261505,2863863,978056,467872,7962393,38.33,6.17
Tender_8060,7754613,3725117,2635268,843321,135562,15093881,46.0,5.4
Tender_8061,2464251,2337166,2968575,331337,151260,8252589,54.0,4.6
Tender_8062,8883231,220793,620136,348969,462005,10535134,47.0,5.3
Tender_8063,7984419,2202396,1640601,855573,321697,13004686,44.0,5.6
Tender_8064,637083,806592,1774662,674720,334425,4227482,45.33,5.47
Tender_8065,2381976,1639550,2420668,249975,485396,7177565,50.0,5.0
Tender_8066,3294310,3212612,480467,243316,100718,7331423,24.67,7.53
Tender_8067,5273876,2677328,2570190,629717,389998,11541109,41.67,5.83
Tender_8068,436375,4157992,2073146,683087,163554,7514154,42.33,5.77
Tender_8069,472719,1265254,1673168,869083,347049,4627273,52.33,4.77
Tender_8070,8407919,2600369,2435711,413680,426115,14283794,40.33,5.97
Tender_8071,5741424,3667403,1698893,405722,163269,11676711,33.33,6.67
Tender_8072,1563960,1811774,876277,522290,283540,5057841,19.67,8.03
Tender_8073,1370099,1895604,873137,681555,120077,4940472,32.33,6.77
Tender_8074,261888,381185,64025,169404,346129,1222631,28.67,7.13
Tender_8075,3327563,1753844,813278,591103,364396,6850184,43.0,5.7
Tender_8076,9738807,2637615,1258156,756792,335371,14726741,29.67,7.03
Tender_8077,4177522,2947788,436192,109281,110718,7781501,34.67,6.53
Tender_8078,4637455,4616916,1367195,395872,342392,11359830,25.67,7.43
Tender_8079,389529,2493593,2972345,248279,307251,6410997,33.33,6.67
Tender_8080,9842947,135730,2653413,834486,256181,13722757,49.0,5.1
Tender_8081,9852412,2408529,2401842,264731,180833,15108347,23.33,7.67
Tender_8082,7126679,1706359,1134891,545127,137192,10650248,35.33,6.47
Tender_8083,6105117,451111,1183138,815291,128113,8682770,27.33,7.27
Tender_8084,7212738,4347596,2521386,885535,392296,15359551,55.67,4.43
Tender_8085,8049240,4885791,1864226,850180,102976,15752413,40.0,6.0
Tender_8086,9554966,2589346,1972353,638429,498927,15254021,53.33,4.67
Tender_8087,9733704,2171049,2942828,846567,76225,15770373,43.0,5.7
Tender_8088,6211151,3753713,2515361,379976,325087,13185288,46.0,5.4
Tender_8089,6572516,3547764,1130548,729516,439355,12419699,45.67,5.43
Tender_8090,4807474,3624806,2291522,170346,96049,10990197,31.67,6.83
Tender_8091,6155071,2584932,2824009,938281,499892,13002185,45.0,5.5
Tender_8092,8990175,4235788,1355792,902386,491133,15975274,48.67,5.13
Tender_8093,1734054,426819,1947135,225916,433711,4767635,39.67,6.03
Tender_8094,7610558,2891200,496645,210206,196111,11404720,20.67,7.93
Tender_8095,1274639,2697099,1735750,230547,187572,6125607,47.33,5.27
Tender_8096,3738112,4066828,2135406,814092,73518,10827956,37.67,6.23
Tender_8097,832630,916243,1610342,649893,486022,4495130,49.67,5.03
Tender_8098,3928028,4962991,1674208,433165,361954,11360346,53.0,4.7
Tender_8099,2900106,4890553,2450336,716023,481424,11438442,36.67,6.33
Tender_8100,2633832,3448285,2837013,699029,162176,9780335,35.67,6.43
Tender_8101,9608780,1088389,1253224,277471,61541,12289405,41.33,5.87
Tender_8102,5096050,1986538,2190546,878411,266403,10417948,50.0,5.0
Tender_8103,5202665,488157,1570766,401187,463171,8125946,35.0,6.5
Tender_8104,3114314,3762947,2726829,730206,348465,10682761,36.0,6.4
Tender_8105,2996405,3125142,1836916,502001,410386,8870850,46.67,5.33
Tender_8106,2000682,4133484,1334131,334926,192614,7995837,25.33,7.47
Tender_8107,3757072,527602,2775010,483044,335728,7878456,40.33,5.97
Tender_8108,9340581,4053675,2402573,114167,140915,16051911,34.33,6.57
Tender_8109,5105566,1138047,1098430,63885,462602,7868530,47.0,5.3
Tender_8110,3620764,1969785,131532,922369,303051,6947501,32.0,6.8
Tender_8111,3850169,258999,2541874,426903,448923,7526868,39.67,6.03
Tender_8112,2344038,4318212,2175759,504048,117858,9459915,44.67,5.53
Tender_8113,1766117,345340,2162119,936333,398922,5608831,27.67,7.23
Tender_8114,4274699,1397370,2566572,168819,92774,8500234,26.0,7.4
Tender_8115,4064195,4365220,277246,356440,183695,9246796,32.0,6.8
Tender_8116,825790,4115434,2358026,143111,483121,7925482,34.67,6.53
Tender_8117,1228389,4554947,391785,883497,315684,7374302,53.67,4.63
Tender_8118,1044109,2785425,1418218,975399,200519,6423670,25.0,7.5
Tender_8119,5053978,1438753,1388835,865360,253381,9000307,49.67,5.03
Tender_8120,2978711,4237251,268726,842241,176151,8503080,39.67,6.03
Tender_8121,5750720,1219029,2837154,99014,203224,10109141,42.67,5.73
Tender_8122,6497852,2338929,1641323,894761,258529,11631394,43.67,5.63
Tender_8123,224519,2705677,1280964,329889,141847,4682896,42.33,5.77
Tender_8124,3385772,362023,297444,928241,286543,5260023,33.33,6.67
Tender_8125,684654,3593807,894186,635808,461021,6269476,43.67,5.63
Tender_8126,2364870,4831283,952799,578730,299287,9026969,23.67,7.63
Tender_8127,3534605,2931505,2820388,449028,97259,9832785,28.33,7.17
Tender_8128,229269,1707622,1537520,581065,183572,4239048,31.33,6.87
Tender_8129,9953241,3212330,2778409,657778,456299,17058057,46.33,5.37
Tender_8130,5873024,715069,1658784,468953,132153,8847983,32.0,6.8
Tender_8131,8650054,4278971,2909559,409790,234247,16482621,36.0,6.4
Tender_8132,8427018,773200,736151,509063,208357,10653789,33.0,6.7
Tender_8133,3263816,4002210,1843557,117313,455268,9682164,43.33,5.67
Tender_8134,642749,1145843,1231733,767924,252623,4040872,37.0,6.3
Tender_8135,3048708,1113867,2896331,326377,407308,7792591,44.0,5.6
Tender_8136,601224,4747647,2746283,489708,493903,9078765,45.67,5.43
Tender_8137,7800240,4372818,249469,990141,494140,13906808,30.67,6.93
Tender_8138,6165119,1170356,2283983,578036,498121,10695615,57.67,4.23
Tender_8139,2770204,1299459,1529266,338469,177670,6115068,42.0,5.8
Tender_8140,1042484,750583,2997416,804090,171124,5765697,20.33,7.97
Tender_8141,533043,2179166,2438174,747845,76870,5975098,43.0,5.7
Tender_8142,3089483,1105906,1475870,565550,309287,6546096,44.0,5.6
Tender_8143,5662405,3822735,1388174,240354,116513,11230181,42.33,5.77
Tender_8144,6192726,1318566,429706,578382,297109,8816489,39.67,6.03
Tender_8145,6790750,2042042,1304210,670714,393045,11200761,31.33,6.87
Tender_8146,3755075,3249458,2568872,465619,161597,10200621,32.33,6.77
Tender_8147,1606046,689448,1587060,284009,84670,4251233,53.0,4.7
Tender_8148,8780574,1812898,1958287,51121,120473,12723353,41.0,5.9
Tender_8149,7452662,1154399,629624,621009,438756,10296450,37.67,6.23
Tender_8150,318385,4667107,2732431,180547,462962,8361432,29.67,7.03
Tender_8151,7500591,417570,2925724,184798,229362,11258045,42.33,5.77
Tender_8152,2919737,278243,716373,832188,277261,5023802,43.33,5.67
Tender_8153,3938140,483535,2404659,766646,348145,7941125,47.67,5.23
Tender_8154,2164123,979853,470413,760435,458292,4833116,28.33,7.17
Tender_8155,4657292,2902605,1637894,135823,254323,9587937,40.33,5.97
Tender_8156,4256531,2608580,195238,667693,252020,7980062,29.0,7.1
Tender_8157,9038055,135699,1411145,504083,99857,11188839,40.67,5.93
Tender_8158,8250738,4478194,2653709,522143,422925,16327709,52.33,4.77
Tender_8159,4922650,4074193,1809265,714085,199797,11719990,33.33,6.67
Tender_8160,5261214,2219780,241963,304515,254963,8282435,38.67,6.13
Tender_8161,4075641,3074908,1410588,710495,367740,9639372,29.67,7.03
Tender_8162,8478631,356342,634712,686141,236651,10392477,42.67,5.73
Tender_8163,4320309,1927648,1661542,556305,254884,8720688,31.67,6.83
Tender_8164,317347,1806675,1927977,178339,108007,4338345,51.67,4.83
Tender_8165,6081668,2232023,383677,888760,185156,9771284,28.0,7.2
Tender_8166,4024739,3562164,1796727,202197,136320,9722147,53.33,4.67
Tender_8167,6108200,3823098,2530247,896450,406343,13764338,47.33,5.27
Tender_8168,7242097,344205,1982363,708908,255765,10533338,27.67,7.23
Tender_8169,2416112,3184836,1971765,448346,474351,8495410,53.0,4.7
Tender_8170,8387608,3947983,2364534,271759,267356,15239240,32.33,6.77
Tender_8171,7139777,3864968,346890,553673,388012,12293320,38.67,6.13
Tender_8172,4163446,1790573,2550410,988903,433027,9926359,47.67,5.23
Tender_8173,440259,3397148,2134617,757746,381925,7111695,39.67,6.03
Tender_8174,786881,2337053,1685930,509891,387137,5706892,28.67,7.13
Tender_8175,8423388,1044981,1960225,242902,82369,11753865,48.0,5.2
Tender_8176,6608115,2473760,2907062,553497,214776,12757210,34.0,6.6
Tender_8177,4047782,604806,971823,261354,170285,6056050,49.33,5.07
Tender_8178,3328540,1569345,560518,62147,148733,5669283,49.67,5.03
Tender_8179,5657737,1636918,1327658,901643,440121,9964077,49.33,5.07
Tender_8180,2501423,3353756,2351526,727095,347906,9281706,28.67,7.13
Tender_8181,7882294,3021809,438404,157758,139121,11639386,45.67,5.43
Tender_8182,4296686,3659726,703930,356682,428476,9445500,46.33,5.37
Tender_8183,7580276,1573492,1160565,82515,54468,10451316,30.33,6.97
Tender_8184,6671735,140197,2101839,595963,158895,9668629,38.0,6.2
Tender_8185,8350056,2378758,2528431,431701,165577,13854523,25.67,7.43
Tender_8186,4541340,4376092,1614472,79890,427645,11039439,28.0,7.2
Tender_8187,9416419,2486900,1836833,729581,52427,14522160,32.67,6.73
Tender_8188,9399367,3391373,219349,570292,58305,13638686,45.33,5.47
Tender_8189,1687738,770878,1410235,92175,363738,4324764,34.33,6.57
Tender_8190,4084216,4776080,2863899,588554,329525,12642274,42.67,5.73
Tender_8191,9899565,570807,125040,409446,361682,11366540,46.0,5.4
Tender_8192,1787341,1346144,2949306,880436,462059,7425286,17.67,8.23
Tender_8193,4801404,4514040,698362,136743,459030,10609579,36.67,6.33
Tender_8194,2654003,4381058,244179,528052,331111,8138403,33.67,6.63
Tender_8195,331833,1348171,1712209,473838,372525,4238576,39.33,6.07
Tender_8196,4075494,1924380,1460793,515329,157820,8133816,24.67,7.53
Tender_8197,8570705,4823043,314777,406500,358926,14473951,47.33,5.27
Tender_8198,6280555,4309458,1372047,783511,262096,13007667,43.33,5.67
Tender_8199,6792966,4622630,1947905,133307,467262,13964070,33.67,6.63
Tender_8200,5402367,2550515,635176,738351,109492,9435901,43.67,5.63
Tender_8201,1250527,1721513,155318,749686,223522,4100566,43.67,5.63
Tender_8202,5389530,4086814,803842,997981,304690,11582857,34.33,6.57
Tender_8203,4364315,4037783,1105070,468839,212856,10188863,28.0,7.2
Tender_8204,1373238,1152260,2763171,131458,201770,5621897,31.33,6.87
Tender_8205,5187728,971151,2883337,82358,167066,9291640,55.33,4.47
Tender_8206,686873,717445,525101,183740,438470,2551629,32.0,6.8
Tender_8207,1905402,4389877,2659463,558017,188189,9700948,52.33,4.77
Tender_8208,4135837,1814886,164485,718999,116508,6950715,55.33,4.47
Tender_8209,9059906,687676,1520627,979332,339242,12586783,43.33,5.67
Tender_8210,9610665,4754666,950429,512398,326936,16155094,37.0,6.3
Tender_8211,8113381,2979544,1634058,657050,99654,13483687,42.67,5.73
Tender_8212,9612419,816258,681843,988445,388375,12487340,39.67,6.03
Tender_8213,5379255,4139199,1863726,636830,484316,12503326,34.67,6.53
Tender_8214,2913827,2727435,901466,935840,457087,7935655,26.33,7.37
Tender_8215,6372919,2120731,2536523,582509,114517,11727199,49.33,5.07
Tender_8216,4242625,379653,1681117,884775,317309,7505479,49.67,5.03
Tender_8217,3591208,4116760,1091275,407107,211681,9418031,26.67,7.33
Tender_8218,7950297,1488797,2389414,303587,259334,12391429,43.33,5.67
Tender_8219,1933209,251013,1415530,280471,480667,4360890,41.67,5.83
Tender_8220,8830792,2270668,1854658,705361,412533,14074012,29.33,7.07
Tender_8221,4488116,4296686,2571157,669487,408105,12433551,39.0,6.1
Tender_8222,3344098,3499237,232515,504123,144451,7724424,51.0,4.9
Tender_8223,9187333,4617187,1570299,145116,356816,15876751,31.67,6.83
Tender_8224,4930586,922822,2753869,690429,314538,9612244,32.67,6.73
Tender_8225,399545,4695958,936570,260093,417941,6710107,60.67,3.93
Tender_8226,9207080,1345298,1633961,768309,432190,13386838,37.67,6.23
Tender_8227,9143189,548374,695798,887586,392905,11667852,44.0,5.6
Tender_8228,8696880,2458437,1499663,589018,141726,13385724,35.67,6.43
Tender_8229,6354271,694402,1783916,139227,57397,9029213,27.67,7.23
Tender_8230,7105343,1148577,2912788,864088,108352,12139148,22.33,7.77
Tender_8231,3920228,1263572,1716213,95682,76612,7072307,45.0,5.5
Tender_8232,8617387,2870213,1601142,553810,307234,13949786,30.67,6.93
Tender_8233,335934,439534,1230497,626198,115981,2748144,38.67,6.13
Tender_8234,3271082,3581600,2238702,816735,143628,10051747,24.0,7.6
Tender_8235,9345038,4762478,491939,199885,395938,15195278,32.67,6.73
Tender_8236,5831010,2091916,2511724,866651,331134,11632435,29.33,7.07
Tender_8237,2692666,1591013,277393,587147,293991,5442210,55.33,4.47
Tender_8238,1357850,636397,507313,304723,110551,2916834,34.67,6.53
Tender_8239,2749670,2244252,2755111,482757,442915,8674705,42.33,5.77
Tender_8240,1056919,2410230,502769,526207,455564,4951689,29.33,7.07
Tender_8241,1019580,3164565,2058443,684168,91786,7018542,36.67,6.33
Tender_8242,5012415,3620154,256252,487809,267023,9643653,47.33,5.27
Tender_8243,1720837,4783808,2035348,784255,199968,9524216,30.33,6.97
Tender_8244,6980179,3639586,2280620,786869,328357,14015611,44.67,5.53
Tender_8245,4678655,1907673,576404,167189,320478,7650399,36.0,6.4
Tender_8246,9498198,791960,2873852,953495,393473,14510978,39.33,6.07
Tender_8247,6234080,2696790,489884,195792,450956,10067502,46.67,5.33
Tender_8248,1759550,3535347,498554,816197,304990,6914638,50.67,4.93
Tender_8249,6372171,4753679,2051630,59297,338224,13575001,42.0,5.8
Tender_8250,6104808,4192681,1813320,887186,406114,13404109,33.0,6.7
Tender_8251,9719874,151345,1196620,934017,368319,12370175,27.33,7.27
Tender_8252,6999748,2415344,1058379,747145,328543,11549159,24.67,7.53
Tender_8253,4590196,756100,2829617,565298,488428,9229639,39.0,6.1
Tender_8254,9266134,917498,2962392,651703,172229,13969956,51.0,4.9
Tender_8255,8203157,3148447,2517996,429072,168517,14467189,39.0,6.1
Tender_8256,729586,1113916,2538302,646793,388623,5417220,35.33,6.47
Tender_8257,3359047,3616062,1869640,565201,305372,9715322,41.33,5.87
Tender_8258,2472088,3613808,186692,67247,169149,6508984,37.0,6.3
Tender_8259,2231199,4997088,1711185,703356,454143,10096971,36.0,6.4
Tender_8260,8885981,2936233,2014175,980509,145391,14962289,34.67,6.53
Tender_8261,7971507,2731270,1547711,252752,66312,12569552,22.33,7.77
Tender_8262,450379,1770822,634374,216572,473650,3545797,40.33,5.97
Tender_8263,4209201,1239591,1157672,159883,145100,6911447,51.33,4.87
Tender_8264,6359085,820113,1997814,333627,237842,9748481,35.0,6.5
Tender_8265,885752,4590432,2950417,168453,160165,8755219,49.33,5.07
Tender_8266,9394991,927546,2966931,626708,223870,14140046,43.33,5.67
Tender_8267,9439028,1005801,1566067,870996,171156,13053048,36.67,6.33
Tender_8268,9385791,1233920,136539,138164,372331,11266745,36.0,6.4
Tender_8269,8869883,2514075,2065952,757732,267481,14475123,44.67,5.53
Tender_8270,4888592,3397159,2778346,618030,215464,11897591,46.33,5.37
Tender_8271,2962518,2201358,343913,359615,443298,6310702,28.33,7.17
Tender_8272,4087778,4485907,782107,289973,398295,10044060,30.33,6.97
Tender_8273,6285714,4761342,2637705,870171,197486,14752418,23.33,7.67
Tender_8274,4647056,496799,1920411,845485,53297,7963048,41.0,5.9
Tender_8275,347253,3875644,2808427,683254,141109,7855687,36.67,6.33
Tender_8276,2468265,4618624,750630,543181,416377,8797077,38.33,6.17
Tender_8277,1359340,4607815,1535536,773186,294876,8570753,39.0,6.1
Tender_8278,7109270,519269,2331046,702196,329484,10991265,32.0,6.8
Tender_8279,9851109,4289796,2340087,103411,265848,16850251,30.0,7.0
Tender_8280,9270708,548583,2046933,148412,481432,12496068,36.67,6.33
Tender_8281,958387,3995601,499463,567773,492961,6514185,47.0,5.3
Tender_8282,7339879,4231590,1067121,799723,222617,13660930,37.0,6.3
Tender_8283,9457602,2069445,622640,347635,407055,12904377,31.67,6.83
Tender_8284,1364814,283663,2781454,907084,451324,5788339,45.0,5.5
Tender_8285,4016726,4946546,779243,73477,268262,10084254,37.33,6.27
Tender_8286,5946284,4810740,2205029,306104,71812,13339969,51.0,4.9
Tender_8287,6735714,2093653,2037635,704196,308963,11880161,45.0,5.5
Tender_8288,3623183,1496653,1532889,957365,194755,7804845,34.67,6.53
Tender_8289,6643297,1589675,1099332,514666,88761,9935731,43.33,5.67
Tender_8290,2654885,1611641,681826,243046,269213,5460611,43.33,5.67
Tender_8291,2596186,4516380,2783927,823631,330867,11050991,27.33,7.27
Tender_8292,4735270,1320259,2214993,245055,322776,8838353,36.0,6.4
Tender_8293,5017503,1113793,2483456,308354,94466,9017572,36.33,6.37
Tender_8294,7460032,153316,161411,341460,381707,8497926,32.0,6.8
Tender_8295,3280856,1258369,145671,231396,89849,5006141,30.67,6.93
Tender_8296,7394375,1085745,1605125,746502,170501,11002248,35.67,6.43
Tender_8297,5796196,3038881,1708054,736518,472803,11752452,29.0,7.1
Tender_8298,6303429,1359942,2015209,145847,200289,10024716,40.0,6.0
Tender_8299,7104654,1743517,1320340,896217,264722,11329450,31.33,6.87
Tender_8300,2240924,2358278,337533,384820,345352,5666907,33.0,6.7
Tender_8301,6322519,4512660,2227979,365848,321503,13750509,45.67,5.43
Tender_8302,8438334,2656126,648794,277540,193770,12214564,45.33,5.47
Tender_8303,7760820,1124316,2764125,619231,96658,12365150,50.67,4.93
Tender_8304,2352647,3939745,2410282,84873,375260,9162807,40.67,5.93
Tender_8305,4042173,1014246,1305026,69197,448380,6879022,39.67,6.03
Tender_8306,5870876,4849851,2835280,907419,485702,14949128,39.67,6.03
Tender_8307,5976618,2079505,917949,528480,340720,9843272,27.0,7.3
Tender_8308,1609476,1149960,214316,185420,474663,3633835,36.0,6.4
Tender_8309,8249251,1466719,1422793,879920,226752,12245435,45.0,5.5
Tender_8310,2416219,2877778,206404,982725,242828,6725954,36.33,6.37
Tender_8311,7940680,3855114,1218367,751246,152900,13918307,49.67,5.03
Tender_8312,4906872,859169,1188201,903601,327166,8185009,43.0,5.7
Tender_8313,9418454,3783919,2315271,911834,350184,16779662,38.0,6.2
Tender_8314,5175076,3900748,904527,646595,170005,10796951,34.33,6.57
Tender_8315,7839755,878633,2423751,197286,474254,11813679,31.33,6.87
Tender_8316,3315063,4419235,324103,269697,101663,8429761,41.67,5.83
Tender_8317,8038048,3077425,2026302,491813,403438,14037026,29.67,7.03
Tender_8318,919589,457917,847118,416666,472160,3113450,45.0,5.5
Tender_8319,6127335,3453729,237068,780006,390254,10988392,37.33,6.27
Tender_8320,9915117,2668834,141963,994022,306247,14026183,31.0,6.9
Tender_8321,4652921,1016926,2397436,515949,229581,8812813,51.33,4.87
Tender_8322,4867699,3916143,1699874,860995,384092,11728803,41.33,5.87
Tender_8323,6539667,4274078,1407960,681532,79586,12982823,46.67,5.33
Tender_8324,1854680,1989087,2891684,601742,380510,7717703,36.0,6.4
Tender_8325,7746060,1194375,2077466,667141,56828,11741870,33.33,6.67
Tender_8326,3953225,302275,2340846,158763,492989,7248098,39.67,6.03
Tender_8327,5490822,1920558,1996406,347059,436177,10191022,25.0,7.5
Tender_8328,4000711,3414566,2471377,503808,354381,10744843,29.33,7.07
Tender_8329,6935172,206244,2113416,637098,225162,10117092,36.67,6.33
Tender_8330,1140484,4122815,271329,404036,264241,6202905,45.67,5.43
Tender_8331,7229317,1082871,1221535,504093,381327,10419143,45.67,5.43
Tender_8332,8594759,2539154,455879,811720,90988,12492500,46.33,5.37
Tender_8333,5014468,4950512,1375265,318330,185378,11843953,46.0,5.4
Tender_8334,5076633,4486095,2036547,680088,343070,12622433,43.33,5.67
Tender_8335,8562586,3907363,1112189,243867,474152,14300157,26.67,7.33
Tender_8336,245386,416534,606317,211780,329495,1809512,33.0,6.7
Tender_8337,7283993,1806021,2666757,497590,61429,12315790,37.67,6.23
Tender_8338,8409071,3895228,2465814,926783,397729,16094625,35.67,6.43
Tender_8339,5356068,4540655,1160721,114271,89124,11260839,36.33,6.37
Tender_8340,279605,2316567,910544,313830,358530,4179076,38.0,6.2
Tender_8341,1264165,2431078,669803,232631,161177,4758854,40.0,6.0
Tender_8342,2831976,3233538,368657,164284,377224,6975679,59.0,4.1
Tender_8343,6669612,4075280,1549811,555567,193421,13043691,20.33,7.97
Tender_8344,701662,3511328,2596052,210149,156379,7175570,28.33,7.17
Tender_8345,2775097,4010429,1816206,429023,201680,9232435,31.33,6.87
Tender_8346,8710289,3739430,1808047,813982,361336,15433084,33.67,6.63
Tender_8347,7837147,1901740,2736388,339948,175251,12990474,47.33,5.27
Tender_8348,1116123,1094863,2302661,822377,328406,5664430,39.33,6.07
Tender_8349,592190,2469090,662450,898788,439571,5062089,41.67,5.83
Tender_8350,7707629,1109438,2428614,88065,437519,11771265,36.33,6.37
Tender_8351,1289634,1850013,816286,149092,300449,4405474,48.0,5.2
Tender_8352,2005543,942419,2078037,317035,91975,5435009,28.67,7.13
Tender_8353,633973,1545069,938523,636114,172404,3926083,23.67,7.63
Tender_8354,7396582,1859007,264691,918966,444119,10883365,36.67,6.33
Tender_8355,5170698,1662451,2695547,920132,182218,10631046,39.67,6.03
Tender_8356,8734156,1589068,2075811,504210,206777,13110022,45.33,5.47
Tender_8357,1089209,2008404,1095122,154314,176767,4523816,44.33,5.57
Tender_8358,2629523,2614621,2644818,205385,346111,8440458,34.67,6.53
Tender_8359,3460614,4229067,1054882,510916,110993,9366472,39.0,6.1
Tender_8360,2631618,4577373,1930143,148593,229093,9516820,36.33,6.37
Tender_8361,6187366,402049,182340,296316,396910,7464981,39.0,6.1
Tender_8362,8728533,444567,2080385,822449,457133,12533067,45.67,5.43
Tender_8363,6858962,514369,932424,801884,362007,9469646,33.33,6.67
Tender_8364,9648239,3056367,1233477,872491,161249,14971823,36.0,6.4
Tender_8365,8754634,353439,2396649,674571,389613,12568906,38.33,6.17
Tender_8366,469029,3689590,1406777,76360,487674,6129430,45.67,5.43
Tender_8367,1239513,3770655,1803644,397899,264160,7475871,45.0,5.5
Tender_8368,9299565,1065226,2073931,253636,311570,13003928,44.0,5.6
Tender_8369,9184348,3127550,1441764,483064,234836,14471562,24.33,7.57
Tender_8370,1855999,3250262,2296475,185589,172449,7760774,50.0,5.0
Tender_8371,4975379,3493039,1339736,501765,235380,10545299,44.0,5.6
Tender_8372,9009611,1862664,2777292,124071,375078,14148716,33.33,6.67
Tender_8373,5245414,3326158,2427142,509317,187333,11695364,44.33,5.57
Tender_8374,9277396,4567542,2542414,572361,279314,17239027,41.67,5.83
Tender_8375,5414914,2838706,65064,870815,210003,9399502,45.33,5.47
Tender_8376,6699478,3710214,2729251,136381,217047,13492371,49.0,5.1
Tender_8377,5719166,4439980,286503,758109,300641,11504399,37.0,6.3
Tender_8378,4598069,4514125,2863226,292892,236641,12504953,31.33,6.87
Tender_8379,1436528,616294,2530475,393201,145734,5122232,47.0,5.3
Tender_8380,1342540,629704,2053244,265975,418844,4710307,44.0,5.6
Tender_8381,3224803,396947,1126829,594668,274922,5618169,46.67,5.33
Tender_8382,4852420,4955218,2528910,738098,429049,13503695,33.33,6.67
Tender_8383,3127642,4226316,2528856,660725,133121,10676660,34.0,6.6
Tender_8384,2623587,1821424,970761,685372,469495,6570639,48.67,5.13
Tender_8385,7098295,2307995,1900486,108983,456657,11872416,29.0,7.1
Tender_8386,1191957,4581180,1499044,645255,113001,8030437,34.33,6.57
Tender_8387,7321818,1656622,1926039,457811,445810,11808100,44.33,5.57
Tender_8388,1581452,497859,2420172,860520,384984,5744987,21.67,7.83
Tender_8389,4388608,2424752,703592,712394,381258,8610604,36.67,6.33
Tender_8390,9532526,3122876,2113135,665207,152253,15585997,42.67,5.73
Tender_8391,3240001,189634,290224,418691,160606,4299156,41.33,5.87
Tender_8392,2210474,3124427,2171363,651235,450287,8607786,30.67,6.93
Tender_8393,8152439,4228790,1618250,355438,340731,14695648,41.0,5.9
Tender_8394,2859124,1870198,1594399,725199,401096,7450016,42.33,5.77
Tender_8395,5448984,1171224,850310,945756,484965,8901239,24.67,7.53
Tender_8396,2620169,3530104,367730,459720,302747,7280470,52.67,4.73
Tender_8397,1499403,3425433,1646012,677298,443260,7691406,34.33,6.57
Tender_8398,9568344,1765137,1702831,458803,377421,13872536,27.0,7.3
Tender_8399,7109745,591596,1510026,208348,261781,9681496,56.0,4.4
Tender_8400,7423952,3106764,286822,645254,53773,11516565,24.33,7.57
Tender_8401,7638715,3587358,1270728,213151,125353,12835305,44.67,5.53
Tender_8402,8876095,1375317,1011451,964504,55868,12283235,51.67,4.83
Tender_8403,2608008,3091641,1299387,365742,211660,7576438,31.0,6.9
Tender_8404,3754855,3813286,1184240,58329,110748,8921458,37.0,6.3
Tender_8405,9940063,1339976,2312378,389567,219373,14201357,33.0,6.7
Tender_8406,7021056,1188093,1269373,635844,226177,10340543,55.0,4.5
Tender_8407,8303392,1810134,1730643,744550,386711,12975430,34.67,6.53
Tender_8408,5620934,4101897,1877849,983743,324824,12909247,44.0,5.6
Tender_8409,7413913,303770,514239,103419,180378,8515719,40.67,5.93
Tender_8410,7818883,4966217,2705634,820616,447176,16758526,52.33,4.77
Tender_8411,7111266,889294,500496,514636,77319,9093011,29.33,7.07
Tender_8412,6422052,2360191,1916471,302655,108763,11110132,37.67,6.23
Tender_8413,5077521,2707381,1983892,971729,401486,11142009,24.67,7.53
Tender_8414,9538506,1441030,423819,492666,365044,12261065,51.67,4.83
Tender_8415,6865160,4601736,1758729,945203,498762,14669590,31.67,6.83
Tender_8416,3960623,4427709,684897,422212,100638,9596079,44.33,5.57
Tender_8417,7747930,2204125,1042800,461833,415473,11872161,56.0,4.4
Tender_8418,9545266,2922571,283747,133582,461522,13346688,18.33,8.17
Tender_8419,8124432,4640507,819404,136806,483157,14204306,28.67,7.13
Tender_8420,9081787,1871994,1228762,588774,266572,13037889,33.0,6.7
Tender_8421,6065408,883337,2191373,724937,205486,10070541,37.0,6.3
Tender_8422,5805238,3695956,700800,942280,471272,11615546,37.0,6.3
Tender_8423,7660053,161282,2452167,524448,443863,11241813,31.67,6.83
Tender_8424,2043257,2522419,2156319,824734,279254,7825983,57.67,4.23
Tender_8425,1551615,3353757,439579,842792,167949,6355692,32.0,6.8
Tender_8426,8952754,434075,938738,321075,115521,10762163,44.33,5.57
Tender_8427,8277219,1009697,2939790,103168,146581,12476455,51.0,4.9
Tender_8428,2396773,1674079,816830,798662,83587,5769931,33.67,6.63
Tender_8429,4935193,1812683,235316,552134,439089,7974415,38.0,6.2
Tender_8430,8902298,170301,588586,775102,128521,10564808,36.0,6.4
Tender_8431,2108558,4250487,2120899,322322,329876,9132142,42.67,5.73
Tender_8432,9094631,3978401,666105,691467,180362,14610966,48.33,5.17
Tender_8433,7643229,1536716,1548707,665421,393463,11787536,35.33,6.47
Tender_8434,503372,3377433,2063744,765302,490978,7200829,30.33,6.97
Tender_8435,7472369,1255038,1460733,125953,166828,10480921,47.0,5.3
Tender_8436,3538951,1332194,744062,847726,430736,6893669,33.0,6.7
Tender_8437,3851609,4338846,810710,943596,92309,10037070,35.0,6.5
Tender_8438,8224653,3931778,1762406,174831,50627,14144295,29.0,7.1
Tender_8439,9213792,3021431,792533,940467,420102,14388325,47.67,5.23
Tender_8440,7847043,558225,1361655,429098,371207,10567228,40.0,6.0
Tender_8441,4590859,2580973,1378332,920600,491293,9962057,21.0,7.9
Tender_8442,7662640,3102967,1289317,426314,75912,12557150,21.33,7.87
Tender_8443,2762845,2051650,2277915,257639,388998,7739047,56.0,4.4
Tender_8444,7108228,1329063,985615,702486,257223,10382615,44.0,5.6
Tender_8445,7629598,4541687,546166,80200,468523,13266174,27.33,7.27
Tender_8446,3751722,1278648,1377812,180419,358348,6946949,18.33,8.17
Tender_8447,2952984,2636393,776337,422006,127681,6915401,44.33,5.57
Tender_8448,6665991,4647142,635838,655114,357434,12961519,42.67,5.73
Tender_8449,8905621,3211811,2437464,704505,214762,15474163,40.0,6.0
Tender_8450,2036339,4393354,951188,951940,110952,8443773,40.67,5.93
Tender_8451,4131614,617425,206950,956165,123547,6035701,45.0,5.5
Tender_8452,7194917,1270549,512222,510653,384550,9872891,27.33,7.27
Tender_8453,1301056,2842221,451989,250976,191420,5037662,39.0,6.1
Tender_8454,5849550,3952810,2099281,469426,407372,12778439,27.67,7.23
Tender_8455,3927846,3492775,2565320,951231,390295,11327467,32.33,6.77
Tender_8456,6893073,4983660,1656498,354640,369829,14257700,28.67,7.13
Tender_8457,5376282,4747472,2297047,989517,56809,13467127,49.33,5.07
Tender_8458,995042,3243323,1567773,289146,360848,6456132,44.33,5.57
Tender_8459,8305795,4400378,454920,879232,143297,14183622,31.33,6.87
Tender_8460,6773409,1713282,1305040,392500,381966,10566197,30.0,7.0
Tender_8461,2437956,4098175,1514874,835569,405534,9292108,49.33,5.07
Tender_8462,970562,1398887,302237,79252,85625,2836563,31.33,6.87
Tender_8463,3154625,3004204,2345533,727629,323928,9555919,50.33,4.97
Tender_8464,9235958,958843,1548960,542177,367366,12653304,25.0,7.5
Tender_8465,2794410,344216,1158360,98997,455573,4851556,35.0,6.5
Tender_8466,684547,4594904,2663882,821075,463072,9227480,44.67,5.53
Tender_8467,8280031,3631243,2778438,169083,72218,14931013,32.33,6.77
Tender_8468,5358229,3769284,376385,709177,82528,10295603,40.0,6.0
Tender_8469,5600744,2593725,637265,897778,399484,10128996,35.33,6.47
Tender_8470,7056227,821029,1265677,700403,65039,9908375,33.33,6.67
Tender_8471,3246973,3994406,2347133,215684,355617,10159813,42.0,5.8
Tender_8472,4875095,1524521,1856251,840770,85071,9181708,34.0,6.6
Tender_8473,1694872,4682692,1866149,659675,178433,9081821,29.67,7.03
Tender_8474,4326068,4700616,2400123,442743,454739,12324289,36.33,6.37
Tender_8475,2599936,2806599,272690,52945,117858,5850028,48.67,5.13
Tender_8476,4892581,3198460,2935167,720911,245436,11992555,25.0,7.5
Tender_8477,5963888,867733,294344,421155,150161,7697281,55.67,4.43
Tender_8478,2021651,4580504,507993,943583,88646,8142377,33.33,6.67
Tender_8479,2364230,4835090,1474216,92709,470345,9236590,43.0,5.7
Tender_8480,4228840,3181842,1726269,905393,104231,10146575,47.0,5.3
Tender_8481,1423128,2845101,1042087,594208,128252,6032776,37.67,6.23
Tender_8482,4990944,2032244,533571,491732,498728,8547219,37.0,6.3
Tender_8483,1608453,2451542,1171382,878105,358493,6467975,23.33,7.67
Tender_8484,4722716,3005589,938587,459001,427935,9553828,47.0,5.3
Tender_8485,3041718,1802776,1986669,132581,75627,7039371,30.33,6.97
Tender_8486,1572626,2422121,1986549,57446,413421,6452163,41.0,5.9
Tender_8487,6097062,3004953,126894,982247,184128,10395284,46.0,5.4
Tender_8488,8934384,1511217,2859388,687322,292814,14285125,52.67,4.73
Tender_8489,2686219,1839434,481005,162024,411454,5580136,56.67,4.33
Tender_8490,5948798,4503164,1338589,818626,138820,12747997,25.33,7.47
Tender_8491,4482056,3166856,956459,773104,456426,9834901,35.0,6.5
Tender_8492,5935309,1519692,2200616,503262,293609,10452488,40.33,5.97
Tender_8493,2166266,1021838,2536076,428758,430875,6583813,38.0,6.2
Tender_8494,4411639,2558373,713617,89802,56753,7830184,29.33,7.07
Tender_8495,3876077,3545081,110508,347954,56939,7936559,40.67,5.93
Tender_8496,5332929,1143149,1320393,711922,174990,8683383,35.0,6.5
Tender_8497,3853913,746698,1287019,718991,412989,7019610,38.0,6.2
Tender_8498,9291066,770949,1742517,894586,393009,13092127,35.0,6.5
Tender_8499,2686839,586584,901172,700698,104178,4979471,31.67,6.83
Tender_8500,5993382,3191455,1387258,255403,462208,11289706,38.67,6.13
Tender_8501,1222092,3010002,2296958,651275,447245,7627572,42.33,5.77
Tender_8502,1149632,3978771,1447756,760798,315860,7652817,49.67,5.03
Tender_8503,9045108,4867856,586176,784015,237507,15520662,29.33,7.07
Tender_8504,6613328,2459049,430952,601405,88454,10193188,40.33,5.97
Tender_8505,2329831,1649814,426476,104050,150641,4660812,41.33,5.87
Tender_8506,798262,1534448,268860,874428,139846,3615844,47.0,5.3
Tender_8507,6049348,2166699,564154,414234,240626,9435061,33.67,6.63
Tender_8508,1360865,2414763,2123064,56868,400398,6355958,39.0,6.1
Tender_8509,1205870,974914,2573124,367068,63689,5184665,32.67,6.73
Tender_8510,3442758,2162795,2508705,881362,481901,9477521,34.0,6.6
Tender_8511,4414280,1324657,754798,372374,240241,7106350,34.0,6.6
Tender_8512,1456200,2667689,280252,224902,176743,4805786,31.33,6.87
Tender_8513,6236810,1454354,1975679,141457,496545,10304845,34.67,6.53
Tender_8514,5290126,3571628,2058018,599748,66291,11585811,33.67,6.63
Tender_8515,2497729,1477905,211520,385687,165447,4738288,39.33,6.07
Tender_8516,9316700,4363330,1523064,172367,185201,15560662,33.0,6.7
Tender_8517,3349602,4616952,2100652,181816,261478,10510500,41.67,5.83
Tender_8518,4942546,1881384,2055539,107187,226270,9212926,31.67,6.83
Tender_8519,9928435,3252957,669408,311269,318732,14480801,41.0,5.9
Tender_8520,4954220,2763614,2656704,722600,217981,11315119,42.0,5.8
Tender_8521,2755805,1064774,2018155,455479,241093,6535306,42.33,5.77
Tender_8522,8876385,3029356,1618930,918788,239923,14683382,45.33,5.47
Tender_8523,4342544,3559456,853003,202929,442227,9400159,45.67,5.43
Tender_8524,6115131,2808227,969853,496141,62382,10451734,42.67,5.73
Tender_8525,2472569,2424894,951732,401412,449141,6699748,48.33,5.17
Tender_8526,7624295,3097348,2738280,838050,489246,14787219,39.33,6.07
Tender_8527,1218467,3517301,1439443,280312,143990,6599513,51.0,4.9
Tender_8528,7234829,159029,1811244,266778,482158,9954038,39.0,6.1
Tender_8529,381503,1995842,1580422,444946,198005,4600718,41.67,5.83
Tender_8530,7683900,3030215,1942492,398532,172234,13227373,44.33,5.57
Tender_8531,8293098,3488549,868578,494141,434844,13579210,34.33,6.57
Tender_8532,1446815,3304746,689158,355330,278261,6074310,35.0,6.5
Tender_8533,4814391,1127249,2516109,304974,67409,8830132,48.67,5.13
Tender_8534,8229939,4234663,1330615,501837,211417,14508471,37.33,6.27
Tender_8535,6845185,1720081,1686178,643955,103572,10998971,30.0,7.0
Tender_8536,5089869,4930996,170424,313092,103264,10607645,37.0,6.3
Tender_8537,2595830,3256504,559859,724410,480088,7616691,37.0,6.3
Tender_8538,4086857,2287999,678707,236996,67491,7358050,39.0,6.1
Tender_8539,6838075,639630,2200492,52977,178501,9909675,26.0,7.4
Tender_8540,1992202,4114482,2294507,518837,281871,9201899,50.0,5.0
Tender_8541,8465930,3414741,2934268,438094,482079,15735112,53.33,4.67
Tender_8542,980775,2942622,1142021,345235,400783,5811436,46.33,5.37
Tender_8543,4135184,4021175,1484113,201491,182394,10024357,29.33,7.07
Tender_8544,2409383,133037,824406,942074,71643,4380543,29.67,7.03
Tender_8545,5442567,4156954,2525813,387467,344782,12857583,34.0,6.6
Tender_8546,3106103,3867326,1684954,413700,274409,9346492,41.33,5.87
Tender_8547,3256613,2327674,2990202,223953,458977,9257419,51.0,4.9
Tender_8548,4003295,4980918,2490849,306381,463050,12244493,52.33,4.77
Tender_8549,4940803,908282,2712295,361927,75826,8999133,53.0,4.7
Tender_8550,1366509,1542905,1018736,812372,469781,5210303,47.0,5.3
Tender_8551,7909241,121350,999536,777718,452424,10260269,35.0,6.5
Tender_8552,7868735,518090,2149339,644129,75458,11255751,46.67,5.33
Tender_8553,2749058,1695903,2623528,952093,205093,8225675,25.67,7.43
Tender_8554,1538389,1189930,1150261,305625,383352,4567557,27.67,7.23
Tender_8555,1965673,3185696,2141397,794076,493611,8580453,41.0,5.9
Tender_8556,7883038,4396906,804886,824816,220919,14130565,31.0,6.9
Tender_8557,1196187,3291883,1839530,189173,114577,6631350,50.0,5.0
Tender_8558,804364,3256893,2508069,865857,122502,7557685,47.33,5.27
Tender_8559,6325964,1731044,2058791,941900,252774,11310473,32.0,6.8
Tender_8560,2928057,4158495,257096,343977,420756,8108381,45.67,5.43
Tender_8561,5028917,360668,2036658,136124,271385,7833752,30.0,7.0
Tender_8562,5471825,1582301,812056,390146,190290,8446618,45.0,5.5
Tender_8563,6800625,766046,1973398,757413,361943,10659425,29.67,7.03
Tender_8564,423723,3556917,2663653,460438,301880,7406611,38.0,6.2
Tender_8565,603245,4842622,94118,578351,341083,6459419,35.67,6.43
Tender_8566,1786926,4448904,2339690,628304,421025,9624849,33.33,6.67
Tender_8567,2872291,4097332,2085405,91980,192742,9339750,45.67,5.43
Tender_8568,8117130,331096,1062144,844601,209342,10564313,41.0,5.9
Tender_8569,2228529,4822250,910432,957931,404740,9323882,41.33,5.87
Tender_8570,8276482,648300,2800472,741979,166186,12633419,40.67,5.93
Tender_8571,3052463,1363028,836783,804263,303007,6359544,41.67,5.83
Tender_8572,837753,3752850,2291986,525144,430134,7837867,38.67,6.13
Tender_8573,9646094,3602288,2708179,200588,251252,16408401,48.0,5.2
Tender_8574,9226609,3982576,401029,628980,494190,14733384,32.0,6.8
Tender_8575,5038485,1020197,1627135,399702,110895,8196414,35.67,6.43
Tender_8576,471261,4076065,2596382,504332,68473,7716513,34.67,6.53
Tender_8577,2824356,1922411,2050326,57850,354538,7209481,32.0,6.8
Tender_8578,7662219,4743034,2894379,79804,456388,15835824,34.67,6.53
Tender_8579,780298,1242048,1548523,561641,128033,4260543,44.67,5.53
Tender_8580,9846569,1902992,300110,279748,240574,12569993,37.0,6.3
Tender_8581,4747709,1820565,1928825,621753,457575,9576427,29.67,7.03
Tender_8582,3493276,4052289,2402782,607467,347499,10903313,36.0,6.4
Tender_8583,1725007,4216751,1010028,697187,195812,7844785,27.0,7.3
Tender_8584,6094716,906856,2954277,899294,199882,11055025,36.0,6.4
Tender_8585,3052934,1892297,2204859,389235,245219,7784544,42.33,5.77
Tender_8586,2165168,301631,2258808,67956,132205,4925768,44.33,5.57
Tender_8587,1752121,1439025,1803787,728393,329362,6052688,38.0,6.2
Tender_8588,8417863,4146624,1497702,729188,473626,15265003,33.33,6.67
Tender_8589,2258336,694092,1509062,173943,282445,4917878,38.33,6.17
Tender_8590,8122532,3065851,2399178,978666,487798,15054025,34.67,6.53
Tender_8591,8973325,840512,2597602,624281,357741,13393461,39.33,6.07
Tender_8592,7187997,1915464,2656355,982980,404146,13146942,44.0,5.6
Tender_8593,3271221,1927680,531163,56165,385048,6171277,59.0,4.1
Tender_8594,5988512,1322886,2688071,753871,481240,11234580,29.0,7.1
Tender_8595,6946390,3722328,910219,886101,106884,12571922,42.33,5.77
Tender_8596,1717922,435588,1425432,398067,190998,4168007,54.67,4.53
Tender_8597,6376239,876034,1306031,133059,324045,9015408,26.33,7.37
Tender_8598,7037650,4656516,1719899,59609,321302,13794976,38.0,6.2
Tender_8599,4239200,4202218,1742359,845474,87892,11117143,54.0,4.6
Tender_8600,7292579,1698457,2751028,867337,396889,13006290,51.67,4.83
Tender_8601,9517654,3626096,1492082,438458,423253,15497543,38.67,6.13
Tender_8602,9308317,2159931,668909,172614,435771,12745542,50.33,4.97
Tender_8603,6887469,4276395,632931,779165,159153,12735113,26.33,7.37
Tender_8604,4774806,3246047,2229423,908597,206192,11365065,48.33,5.17
Tender_8605,6673833,1599483,2430329,805219,461186,11970050,45.0,5.5
Tender_8606,5872021,4141409,1979142,133798,99216,12225586,42.33,5.77
Tender_8607,498881,2603753,1483792,648631,245869,5480926,20.67,7.93
Tender_8608,4971383,1448316,989961,902996,305268,8617924,38.0,6.2
Tender_8609,5635930,497851,1088707,263797,430835,7917120,46.33,5.37
Tender_8610,6502611,4627687,2616707,138829,360923,14246757,35.33,6.47
Tender_8611,9844663,3455173,2835832,838232,102970,17076870,36.0,6.4
Tender_8612,6695256,503219,1745276,791583,371200,10106534,34.0,6.6
Tender_8613,288289,415006,2403775,348122,123312,3578504,33.33,6.67
Tender_8614,7157011,1597229,2380696,381987,359613,11876536,31.67,6.83
Tender_8615,2884581,952150,1829410,65472,92019,5823632,42.33,5.77
Tender_8616,8887511,1029671,308505,376566,141863,10744116,50.67,4.93
Tender_8617,6076286,1373125,329774,168381,271848,8219414,44.0,5.6
Tender_8618,4021648,2617982,246730,147195,341663,7375218,36.0,6.4
Tender_8619,6678827,749980,736235,709838,190614,9065494,26.67,7.33
Tender_8620,8384119,3490619,1473819,433619,306761,14088937,34.67,6.53
Tender_8621,5391258,2486504,1719734,579489,417038,10594023,36.0,6.4
Tender_8622,3055868,2374122,2878215,788011,107653,9203869,36.0,6.4
Tender_8623,9573296,3925214,2778701,183760,253107,16714078,56.67,4.33
Tender_8624,1326451,3526410,2539172,194211,380777,7967021,46.33,5.37
Tender_8625,9068269,4467386,2256911,602619,307588,16702773,31.67,6.83
Tender_8626,8086894,4609507,749686,204177,104375,13754639,40.0,6.0
Tender_8627,1480844,1417482,2654376,378331,88615,6019648,45.67,5.43
Tender_8628,1436352,2246969,2516943,578912,69998,6849174,45.67,5.43
Tender_8629,3583723,4674126,1889737,425971,71271,10644828,32.67,6.73
Tender_8630,7092887,2120626,2950164,538860,286641,12989178,46.67,5.33
Tender_8631,4116005,1212180,1826422,791040,372518,8318165,29.67,7.03
Tender_8632,6084447,1751268,2446755,519600,344232,11146302,48.33,5.17
Tender_8633,5047244,784457,2601669,934627,236367,9604364,41.33,5.87
Tender_8634,3406437,3852521,1911210,59125,90223,9319516,34.67,6.53
Tender_8635,2166908,2284948,424599,225938,352056,5454449,21.33,7.87
Tender_8636,4099638,4624328,1238055,639897,143396,10745314,48.0,5.2
Tender_8637,4287438,2628808,1869601,634147,451408,9871402,30.0,7.0
Tender_8638,2172893,4333793,2217461,717660,386567,9828374,26.33,7.37
Tender_8639,1746381,4047888,2458415,90923,104362,8447969,34.33,6.57
Tender_8640,2571850,2308827,2293507,523140,331671,8028995,18.67,8.13
Tender_8641,8404956,1045987,2609070,791775,80760,12932548,47.0,5.3
Tender_8642,1072548,3244154,1705569,916033,190922,7129226,20.0,8.0
Tender_8643,7528128,1301270,2704433,172523,496891,12203245,39.0,6.1
Tender_8644,4996840,209786,874488,688604,175157,6944875,40.33,5.97
Tender_8645,5569080,1849782,595008,853847,354215,9221932,38.33,6.17
Tender_8646,5393742,908328,2007482,721173,463460,9494185,28.0,7.2
Tender_8647,8254989,2608671,1990166,436043,360024,13649893,31.33,6.87
Tender_8648,9066930,3997533,1464129,491409,278500,15298501,40.0,6.0
Tender_8649,3636150,3237502,1187008,79490,355553,8495703,35.67,6.43
Tender_8650,9782647,2691477,118249,410487,132396,13135256,39.67,6.03
Tender_8651,9708704,4439702,1426811,188632,381220,16145069,33.67,6.63
Tender_8652,527794,4485765,1596437,584863,306659,7501518,44.33,5.57
Tender_8653,4882735,306585,1554009,931425,474645,8149399,42.33,5.77
Tender_8654,9907587,3282151,217476,428417,112384,13948015,32.0,6.8
Tender_8655,8150691,815124,2333576,725581,283760,12308732,43.33,5.67
Tender_8656,1700502,4050781,2707501,789343,278445,9526572,46.0,5.4
Tender_8657,503736,2653296,863055,919033,353351,5292471,37.0,6.3
Tender_8658,4210711,4204216,1148721,764338,153326,10481312,41.67,5.83
Tender_8659,870453,2159538,2355551,444286,184703,6014531,42.67,5.73
Tender_8660,3718526,4415465,1205492,204303,163810,9707596,49.33,5.07
Tender_8661,3986591,2103644,61893,407149,108878,6668155,44.33,5.57
Tender_8662,8163782,3411573,921947,391706,300774,13189782,38.33,6.17
Tender_8663,2139932,3660969,1711150,722925,243091,8478067,44.67,5.53
Tender_8664,6988510,2487737,582554,593103,124717,10776621,46.67,5.33
Tender_8665,1390879,4194578,2372397,131666,167768,8257288,39.0,6.1
Tender_8666,8813330,1045888,2558021,781769,66732,13265740,43.33,5.67
Tender_8667,5818636,4410276,2646940,837501,155389,13868742,40.0,6.0
Tender_8668,224829,1855365,1413716,304096,431080,4229086,40.67,5.93
Tender_8669,2898239,2487183,1406887,832562,244509,7869380,48.0,5.2
Tender_8670,7964895,2456168,1234221,487031,401224,12543539,42.33,5.77
Tender_8671,6889960,4542260,1353298,447940,130493,13363951,49.33,5.07
Tender_8672,7566644,3063023,1140519,478419,268356,12516961,37.67,6.23
Tender_8673,1078332,3309256,2074007,138349,414867,7014811,36.67,6.33
Tender_8674,7392496,2567246,2422609,861906,54222,13298479,53.0,4.7
Tender_8675,4518090,3988838,575418,608807,147466,9838619,39.0,6.1
Tender_8676,4940946,1396017,2279372,631772,460989,9709096,27.67,7.23
Tender_8677,301997,3074658,2559770,84806,193493,6214724,35.67,6.43
Tender_8678,3719430,3179406,2069630,104174,314052,9386692,31.0,6.9
Tender_8679,699553,2166351,76758,696474,275852,3914988,46.67,5.33
Tender_8680,5573503,3659394,2472084,736891,367582,12809454,48.33,5.17
Tender_8681,8272938,2750515,753577,871682,250092,12898804,39.33,6.07
Tender_8682,7583865,3190024,1742956,770572,263099,13550516,37.67,6.23
Tender_8683,7341691,2734213,2239985,529985,175032,13020906,38.0,6.2
Tender_8684,1656153,3378737,2428016,212775,396391,8072072,45.33,5.47
Tender_8685,5082006,145306,2268686,338392,231848,8066238,16.0,8.4
Tender_8686,406762,2958790,573193,437033,310267,4686045,60.67,3.93
Tender_8687,6629180,1589439,649928,948183,152541,9969271,33.0,6.7
Tender_8688,2775480,1689578,2826488,882599,446282,8620427,39.33,6.07
Tender_8689,6773218,1790925,428871,928347,213316,10134677,55.0,4.5
Tender_8690,571932,4442964,470625,682847,456505,6624873,49.33,5.07
Tender_8691,931546,4968034,2313745,440650,434210,9088185,35.67,6.43
Tender_8692,5975350,1259508,1379979,989984,269631,9874452,44.33,5.57
Tender_8693,4968260,2784150,2399369,390612,124826,10667217,50.33,4.97
Tender_8694,2794533,1001413,2291060,202416,172585,6462007,47.0,5.3
Tender_8695,9560849,3619533,1447762,148861,146323,14923328,28.0,7.2
Tender_8696,7148965,1128075,967902,194199,459691,9898832,40.67,5.93
Tender_8697,3805107,2008778,913709,939489,403186,8070269,58.0,4.2
Tender_8698,6032575,309106,2574980,952248,442964,10311873,43.0,5.7
Tender_8699,8395665,3591525,2711132,192027,95306,14985655,36.0,6.4
Tender_8700,4910906,4650210,2950288,159631,257703,12928738,43.0,5.7
Tender_8701,842461,1993238,734448,950688,327030,4847865,47.0,5.3
Tender_8702,9553210,962621,2541266,394844,461031,13912972,57.67,4.23
Tender_8703,8648676,1630073,1601265,437578,138780,12456372,37.67,6.23
Tender_8704,5859171,1275989,1888079,474889,201098,9699226,46.33,5.37
Tender_8705,1993059,4502799,2933438,765029,454443,10648768,48.67,5.13
Tender_8706,7635892,2973359,2319636,251201,101229,13281317,45.0,5.5
Tender_8707,5354282,390306,1671610,161856,356173,7934227,30.67,6.93
Tender_8708,4654942,2102531,1504568,754113,281138,9297292,53.33,4.67
Tender_8709,5181245,2243676,124880,340913,222669,8113383,26.0,7.4
Tender_8710,5066841,818996,2568185,741177,180689,9375888,30.0,7.0
Tender_8711,1453434,1717148,1497029,324025,161499,5153135,42.0,5.8
Tender_8712,4285295,2855190,2819238,748016,121773,10829512,41.67,5.83
Tender_8713,9042536,407370,2760014,79630,342548,12632098,38.0,6.2
Tender_8714,9358234,4292051,599311,331393,460428,15041417,39.33,6.07
Tender_8715,2377826,479346,1388954,389376,480570,5116072,28.67,7.13
Tender_8716,5501441,3380271,1700476,765133,196362,11543683,32.0,6.8
Tender_8717,9276011,4000188,942242,507549,67210,14793200,54.67,4.53
Tender_8718,3236570,826299,302224,576712,357000,5298805,45.33,5.47
Tender_8719,4317095,3089831,2268418,892927,166029,10734300,25.67,7.43
Tender_8720,6095645,832746,72563,982897,365675,8349526,41.0,5.9
Tender_8721,5960081,2777298,257025,325194,430733,9750331,33.67,6.63
Tender_8722,2626464,1425007,198658,933591,184908,5368628,42.0,5.8
Tender_8723,6783286,3163556,204308,558611,125261,10835022,33.0,6.7
Tender_8724,4026346,4710361,1048682,974824,463138,11223351,26.67,7.33
Tender_8725,7914524,3326168,2946418,983857,177587,15348554,47.0,5.3
Tender_8726,3649781,1625332,2343777,527760,240611,8387261,35.33,6.47
Tender_8727,4315883,1049454,510327,391049,480325,6747038,25.0,7.5
Tender_8728,9181710,4202834,156380,922528,65408,14528860,29.0,7.1
Tender_8729,1190828,423960,1947876,508294,160114,4231072,47.0,5.3
Tender_8730,6631269,224548,1194501,219403,170438,8440159,38.67,6.13
Tender_8731,1879465,4341811,510886,449247,148779,7330188,27.33,7.27
Tender_8732,8509796,4036113,779212,701267,271310,14297698,23.33,7.67
Tender_8733,8232423,4353350,1868324,172855,220755,14847707,34.33,6.57
Tender_8734,8797854,667441,2786090,351986,499770,13103141,36.33,6.37
Tender_8735,9660397,1728760,251049,233364,263679,12137249,40.0,6.0
Tender_8736,951714,1565830,87965,809761,194297,3609567,32.33,6.77
Tender_8737,4938481,766137,2644098,219827,97084,8665627,49.33,5.07
Tender_8738,3703917,888042,425457,726791,333418,6077625,29.67,7.03
Tender_8739,9163981,1020398,273039,660087,115209,11232714,47.33,5.27
Tender_8740,1650263,1047164,987212,202386,251420,4138445,43.0,5.7
Tender_8741,1088154,4588230,359099,528672,130693,6694848,38.33,6.17
Tender_8742,373042,1598649,632137,161244,158562,2923634,48.0,5.2
Tender_8743,6854631,3964373,2257946,54433,52642,13184025,35.0,6.5
Tender_8744,3819271,4666533,244990,453373,361698,9545865,37.67,6.23
Tender_8745,2005727,2649170,1921368,890685,136624,7603574,42.67,5.73
Tender_8746,244767,614079,2850385,671967,286917,4668115,52.0,4.8
Tender_8747,5486471,3180882,2678620,555464,71431,11972868,38.67,6.13
Tender_8748,6103546,4306119,646284,475667,311166,11842782,37.67,6.23
Tender_8749,668757,1273759,2542812,891590,317926,5694844,33.67,6.63
Tender_8750,7943752,4227241,2609878,518344,383164,15682379,44.67,5.53
Tender_8751,6959305,2064604,2924813,381665,484938,12815325,35.67,6.43
Tender_8752,2287452,2446317,1323195,817517,404599,7279080,61.33,3.87
Tender_8753,4482175,3178236,2786559,908890,392307,11748167,40.67,5.93
Tender_8754,279251,4490156,1229897,402695,253472,6655471,31.33,6.87
Tender_8755,4609807,3325064,1943978,707636,328631,10915116,56.33,4.37
Tender_8756,8834341,3074999,1118915,593467,362692,13984414,53.0,4.7
Tender_8757,7397317,4703804,1652996,309771,92612,14156500,33.0,6.7
Tender_8758,8690059,4997907,727325,902801,72645,15390737,41.0,5.9
Tender_8759,8043682,4578139,793574,150988,457652,14024035,36.67,6.33
Tender_8760,2092545,4995098,1751405,133786,408323,9381157,39.0,6.1
Tender_8761,7475951,1592692,2654456,108987,55425,11887511,29.67,7.03
Tender_8762,1196308,585927,1672044,608333,343522,4406134,28.33,7.17
Tender_8763,8273415,4693333,1243316,924051,463289,15597404,49.33,5.07
Tender_8764,4250478,3087150,197683,160012,293565,7988888,42.33,5.77
Tender_8765,3981067,4497387,2140492,223892,133920,10976758,53.0,4.7
Tender_8766,9534263,1616483,1667636,251613,366307,13436302,38.33,6.17
Tender_8767,2653452,2349455,1066616,330939,448178,6848640,24.0,7.6
Tender_8768,1990968,2763810,2335884,612591,144264,7847517,33.0,6.7
Tender_8769,1154386,2888197,1683987,681438,184874,6592882,43.0,5.7
Tender_8770,3248981,221058,985225,309663,460397,5225324,42.0,5.8
Tender_8771,1094971,1680675,2690689,910777,119962,6497074,41.67,5.83
Tender_8772,974086,892481,417064,245074,353325,2882030,45.33,5.47
Tender_8773,2005164,3719322,2192255,275267,351551,8543559,36.33,6.37
Tender_8774,2155741,2086106,1728921,458676,355422,6784866,32.0,6.8
Tender_8775,4878255,471809,1004255,355499,424520,7134338,52.67,4.73
Tender_8776,9018580,4160489,1120809,719085,74903,15093866,44.0,5.6
Tender_8777,2513369,2089671,1455927,400632,471527,6931126,34.33,6.57
Tender_8778,2163027,1840803,1577519,145587,248890,5975826,47.0,5.3
Tender_8779,6606191,3004234,1367775,755520,155431,11889151,43.67,5.63
Tender_8780,9507547,4627056,1321141,172494,430594,16058832,30.67,6.93
Tender_8781,6055729,2814430,2027680,621796,470195,11989830,39.33,6.07
Tender_8782,580856,3909732,100885,503391,472978,5567842,35.67,6.43
Tender_8783,9829529,3003211,1794404,391348,349642,15368134,39.0,6.1
Tender_8784,8783780,706539,196817,692381,484835,10864352,41.33,5.87
Tender_8785,4888286,1209978,2700545,598659,269969,9667437,48.33,5.17
Tender_8786,7965021,1582544,2122957,715176,306474,12692172,54.67,4.53
Tender_8787,3436810,3028556,2148028,140270,287247,9040911,21.67,7.83
Tender_8788,8939432,1798373,276124,539667,167420,11721016,48.0,5.2
Tender_8789,3886912,4246808,1585569,826930,363577,10909796,46.0,5.4
Tender_8790,6658698,3615076,1353619,989450,143031,12759874,38.67,6.13
Tender_8791,4512844,4427616,69323,844840,462326,10316949,32.33,6.77
Tender_8792,6758391,2700323,1904007,501922,390402,12255045,48.0,5.2
Tender_8793,387380,4481426,522792,55232,166948,5613778,49.0,5.1
Tender_8794,7271560,1298730,757069,630210,392481,10350050,42.33,5.77
Tender_8795,2095413,4712750,2530794,812925,482114,10633996,41.0,5.9
Tender_8796,434479,1319017,2242408,746584,145788,4888276,25.33,7.47
Tender_8797,7369929,2287063,2644547,99848,385619,12787006,33.33,6.67
Tender_8798,795819,860469,2541373,546725,225136,4969522,23.67,7.63
Tender_8799,3906372,619779,2092011,680424,111537,7410123,24.67,7.53
Tender_8800,4125312,2390508,2426394,347255,114798,9404267,18.67,8.13
Tender_8801,8921216,1199994,86794,926028,137817,11271849,44.67,5.53
Tender_8802,2804412,238048,508587,922089,267528,4740664,35.67,6.43
Tender_8803,2676907,3849643,388388,473433,458436,7846807,54.0,4.6
Tender_8804,3715707,870651,2108364,480668,314288,7489678,27.67,7.23
Tender_8805,9472430,427879,1838397,796750,404452,12939908,30.0,7.0
Tender_8806,2981872,836424,652736,164893,161623,4797548,31.0,6.9
Tender_8807,3265362,3006313,392170,286737,176138,7126720,46.0,5.4
Tender_8808,4221388,3614033,1457154,113502,460567,9866644,29.33,7.07
Tender_8809,6474737,1959432,2154640,261209,98536,10948554,39.33,6.07
Tender_8810,3755051,1961139,2205509,74595,282710,8279004,35.33,6.47
Tender_8811,7889634,4971720,2017412,813543,469855,16162164,51.33,4.87
Tender_8812,5515265,927460,1028459,298479,416834,8186497,16.67,8.33
Tender_8813,5667023,4487814,399001,901625,197853,11653316,39.33,6.07
Tender_8814,8534963,445858,1207974,413934,170003,10772732,41.0,5.9
Tender_8815,2480146,4064983,1393612,451573,73100,8463414,34.33,6.57
Tender_8816,8002829,3019477,2870423,202847,95424,14191000,44.0,5.6
Tender_8817,823040,4273988,219261,710309,305760,6332358,38.67,6.13
Tender_8818,5790116,3300692,2817450,235224,88217,12231699,38.33,6.17
Tender_8819,2415577,2431007,1021260,140005,473361,6481210,24.67,7.53
Tender_8820,5518040,2513984,1092444,248888,481938,9855294,37.67,6.23
Tender_8821,672027,1812900,508287,996538,348271,4338023,33.33,6.67
Tender_8822,1284573,1549514,1603981,405742,362612,5206422,43.67,5.63
Tender_8823,9320366,1325861,615042,64161,427479,11752909,43.33,5.67
Tender_8824,9180423,4936713,934091,469106,86557,15606890,33.33,6.67
Tender_8825,7653802,1744481,1578205,326260,489724,11792472,43.67,5.63
Tender_8826,2744038,1677901,759994,543520,73275,5798728,27.0,7.3
Tender_8827,976828,376472,2904133,189747,263419,4710599,36.33,6.37
Tender_8828,7065242,4290816,1408617,756788,218910,13740373,49.33,5.07
Tender_8829,6934899,2693722,874367,75668,83720,10662376,55.33,4.47
Tender_8830,6238943,1462803,811652,741570,438707,9693675,39.67,6.03
Tender_8831,7603573,1702445,670657,712071,415914,11104660,42.33,5.77
Tender_8832,8526550,1349600,194779,671271,296277,11038477,58.67,4.13
Tender_8833,7014419,4708375,2373759,442272,432722,14971547,29.67,7.03
Tender_8834,8368796,2150041,2692565,608901,488640,14308943,39.67,6.03
Tender_8835,8004713,847513,2876871,541765,208580,12479442,36.33,6.37
Tender_8836,9373278,428720,433486,473855,228499,10937838,38.33,6.17
Tender_8837,8662475,2705454,826716,62638,488484,12745767,28.67,7.13
Tender_8838,8111356,4915528,2914179,760170,486912,17188145,41.67,5.83
Tender_8839,2260670,4806374,2136372,122411,340154,9665981,46.67,5.33
Tender_8840,3382623,4640902,1358223,782941,71110,10235799,60.33,3.97
Tender_8841,366697,542599,2593520,716485,372534,4591835,34.0,6.6
Tender_8842,8796361,3617549,2545498,218052,460696,15638156,43.33,5.67
Tender_8843,4464278,4835116,1061695,829054,369026,11559169,43.67,5.63
Tender_8844,8632941,2603432,2542525,825668,296713,14901279,43.0,5.7
Tender_8845,3738427,2369335,379223,145221,207223,6839429,42.0,5.8
Tender_8846,8528853,410940,2569324,298308,94193,11901618,43.33,5.67
Tender_8847,2398955,3516636,268653,771867,271983,7228094,34.33,6.57
Tender_8848,225376,1791228,79048,283449,198659,2577760,36.67,6.33
Tender_8849,861178,3967205,455989,102618,438456,5825446,44.0,5.6
Tender_8850,6773600,1260282,439694,834831,369942,9678349,42.67,5.73
Tender_8851,7332922,749183,597912,405392,141956,9227365,34.0,6.6
Tender_8852,3768919,1872413,2199739,539775,285382,8666228,44.33,5.57
Tender_8853,2382056,3725830,1178316,746620,168921,8201743,35.67,6.43
Tender_8854,5813809,3709536,276863,141281,62589,10004078,36.0,6.4
Tender_8855,7369561,1086009,462730,896675,229337,10044312,38.33,6.17
Tender_8856,8724921,3217797,2128507,427701,230447,14729373,33.67,6.63
Tender_8857,9651675,1554757,638390,161689,356320,12362831,55.0,4.5
Tender_8858,9273719,4817216,982631,678966,160138,15912670,31.67,6.83
Tender_8859,6507344,1462688,1141657,975327,110381,10197397,19.0,8.1
Tender_8860,6135496,1619582,1142535,429037,371576,9698226,41.67,5.83
Tender_8861,7570767,2374139,1698856,689959,200429,12534150,48.67,5.13
Tender_8862,5402314,3734518,2141720,283175,116184,11677911,37.0,6.3
Tender_8863,8611747,2160193,2091686,260159,265476,13389261,37.33,6.27
Tender_8864,4266680,4477621,2696686,552562,79542,12073091,48.0,5.2
Tender_8865,6922743,1458100,2983254,990177,381870,12736144,32.0,6.8
Tender_8866,8007178,3176856,2685358,197277,126697,14193366,32.0,6.8
Tender_8867,506619,3265753,2458115,435892,104287,6770666,43.0,5.7
Tender_8868,7439979,3799967,2771542,134852,339939,14486279,20.0,8.0
Tender_8869,1300851,898706,1582080,268215,99442,4149294,27.0,7.3
Tender_8870,9717457,3604089,736945,926449,430549,15415489,51.33,4.87
Tender_8871,8492406,759440,1717574,287148,143799,11400367,24.33,7.57
Tender_8872,6206738,3904069,2355935,609745,359116,13435603,21.67,7.83
Tender_8873,337926,2768380,2517609,504565,357476,6485956,60.33,3.97
Tender_8874,240399,3182078,230623,844538,240857,4738495,51.33,4.87
Tender_8875,3852061,2545618,2281364,274465,392994,9346502,48.0,5.2
Tender_8876,8991029,852545,706888,653792,293884,11498138,52.33,4.77
Tender_8877,1489440,2133564,1742503,691041,319594,6376142,35.33,6.47
Tender_8878,5212840,1915331,2195373,522779,236182,10082505,43.0,5.7
Tender_8879,1139144,367875,408066,415075,338387,2668547,46.33,5.37
Tender_8880,4518080,4416300,1382442,353031,371705,11041558,42.67,5.73
Tender_8881,3639577,1007719,1153108,505313,52952,6358669,51.67,4.83
Tender_8882,9567407,3195991,687163,623117,68864,14142542,33.67,6.63
Tender_8883,9274447,665768,1045727,210330,408127,11604399,35.67,6.43
Tender_8884,240985,680611,2326329,783189,89259,4120373,43.67,5.63
Tender_8885,1681623,2010853,803994,251476,271087,5019033,26.67,7.33
Tender_8886,6131442,358959,2492306,581187,287294,9851188,29.67,7.03
Tender_8887,3631230,421518,384516,405550,344036,5186850,49.33,5.07
Tender_8888,1376382,772991,2531864,546979,58359,5286575,30.0,7.0
Tender_8889,6125155,437529,1797159,257257,479068,9096168,31.33,6.87
Tender_8890,306149,2891509,2602806,176911,280539,6257914,41.67,5.83
Tender_8891,374560,4729477,2182653,185379,157327,7629396,36.67,6.33
Tender_8892,6246491,1043061,2348772,436859,368683,10443866,47.0,5.3
Tender_8893,9140126,1003174,226592,519264,227663,11116819,38.67,6.13
Tender_8894,3723131,2227335,2982379,275444,260164,9468453,32.33,6.77
Tender_8895,6421981,2244794,1223689,283874,382233,10556571,21.0,7.9
Tender_8896,3391581,1948081,2473998,967570,446601,9227831,50.67,4.93
Tender_8897,5274896,2610225,2953633,334893,126758,11300405,47.67,5.23
Tender_8898,9290323,1251713,348024,89278,167693,11147031,45.0,5.5
Tender_8899,5582347,2205728,2548913,990247,446497,11773732,26.0,7.4
Tender_8900,9507024,4928108,2350480,951241,491371,18228224,37.67,6.23
Tender_8901,5121274,2377691,2773864,378925,454589,11106343,33.33,6.67
Tender_8902,3286147,668478,331078,251534,333751,4870988,52.67,4.73
Tender_8903,5743523,2929339,2078924,311423,100461,11163670,40.0,6.0
Tender_8904,5709086,3347558,65256,640829,458593,10221322,41.67,5.83
Tender_8905,6871361,1135236,2775323,888725,137389,11808034,30.0,7.0
Tender_8906,1353941,1721184,122697,657152,296104,4151078,46.33,5.37
Tender_8907,4820372,3130903,539347,726097,446214,9662933,37.33,6.27
Tender_8908,1260908,2686867,1619611,58664,407766,6033816,53.67,4.63
Tender_8909,7606969,3323623,2587946,862045,466211,14846794,42.0,5.8
Tender_8910,8935289,3260749,528794,744632,310012,13779476,34.67,6.53
Tender_8911,5260292,1752708,2459481,229185,334280,10035946,32.67,6.73
Tender_8912,3866537,4819115,2002058,491401,189322,11368433,34.0,6.6
Tender_8913,7770823,236033,1928113,405912,463859,10804740,47.33,5.27
Tender_8914,6742879,3800518,86192,686122,76425,11392136,32.67,6.73
Tender_8915,672960,1737426,1939525,207963,108433,4666307,14.0,8.6
Tender_8916,1844890,4366967,1301011,505942,258842,8277652,42.0,5.8
Tender_8917,8952853,3959044,1187066,471365,452255,15022583,49.67,5.03
Tender_8918,3525837,2921328,989835,398003,438873,8273876,29.0,7.1
Tender_8919,3335949,3753068,2690723,72491,343325,10195556,25.33,7.47
Tender_8920,6222294,2730816,2850822,922831,313600,13040363,25.67,7.43
Tender_8921,8216100,3613884,1138105,643534,414971,14026594,36.67,6.33
Tender_8922,9775065,1114909,2034399,297418,372954,13594745,46.67,5.33
Tender_8923,8781462,4833060,2683178,920670,494514,17712884,39.0,6.1
Tender_8924,2172555,706619,2176008,556288,303727,5915197,42.0,5.8
Tender_8925,6649180,881475,647082,260508,125634,8563879,39.33,6.07
Tender_8926,6157615,1545314,412695,897046,409701,9422371,41.33,5.87
Tender_8927,4080389,2571119,2006744,96960,459316,9214528,34.33,6.57
Tender_8928,6342483,4939009,2881407,109372,284250,14556521,43.67,5.63
Tender_8929,2707248,141680,956822,153731,212404,4171885,33.67,6.63
Tender_8930,4579464,2584729,2381826,482788,331929,10360736,36.33,6.37
Tender_8931,7028762,452876,2423517,256010,236706,10397871,45.67,5.43
Tender_8932,3390101,702231,533523,629136,249653,5504644,35.67,6.43
Tender_8933,7373228,1307608,1239732,620320,92086,10632974,36.33,6.37
Tender_8934,1068143,4116889,1573658,123834,165661,7048185,28.67,7.13
Tender_8935,4566504,1251402,1585180,547381,253709,8204176,43.67,5.63
Tender_8936,3282743,2665606,90501,562737,251485,6853072,52.33,4.77
Tender_8937,5703987,1041684,1530811,187221,134103,8597806,44.33,5.57
Tender_8938,9808825,4243424,1773382,754046,265842,16845519,29.0,7.1
Tender_8939,9959247,3062463,2738930,209533,142368,16112541,37.33,6.27
Tender_8940,557788,348994,1350165,65290,344501,2666738,41.67,5.83
Tender_8941,4530789,1372676,2740003,895924,281928,9821320,58.33,4.17
Tender_8942,321070,4368138,2920346,141626,149393,7900573,43.33,5.67
Tender_8943,1356925,4768029,2855192,61077,204631,9245854,35.67,6.43
Tender_8944,4256587,3938018,2672430,710538,197756,11775329,25.67,7.43
Tender_8945,9819294,1761242,721209,805918,332626,13440289,40.67,5.93
Tender_8946,5447026,2147158,118672,958785,294727,8966368,24.0,7.6
Tender_8947,9596523,4744457,611045,247660,255813,15455498,48.33,5.17
Tender_8948,9838603,649382,1223282,957687,461062,13130016,54.33,4.57
Tender_8949,8750381,3828246,1175971,231749,118861,14105208,36.0,6.4
Tender_8950,1537092,2297414,1818024,590550,95986,6339066,22.67,7.73
Tender_8951,8738704,3031948,1327751,994357,346356,14439116,40.0,6.0
Tender_8952,5081592,2651034,697766,280963,404588,9115943,43.33,5.67
Tender_8953,4156824,4600365,2243506,139897,324428,11465020,50.0,5.0
Tender_8954,3327370,3069374,1486965,136415,119244,8139368,44.67,5.53
Tender_8955,4888109,3567548,2485358,119552,455330,11515897,44.0,5.6
Tender_8956,5359183,1614772,1601049,55790,89311,8720105,40.67,5.93
Tender_8957,6274358,4028648,654922,964400,93539,12015867,36.0,6.4
Tender_8958,8526680,3093781,1475893,246890,404512,13747756,36.0,6.4
Tender_8959,5411761,3795363,743707,690834,128856,10770521,34.33,6.57
Tender_8960,4127971,4078350,2895012,946171,102371,12149875,41.33,5.87
Tender_8961,5434106,3883229,2470135,534475,308618,12630563,32.67,6.73
Tender_8962,3270387,3991694,832033,356987,490942,8942043,24.67,7.53
Tender_8963,5483916,4739345,1250434,547558,314736,12335989,37.67,6.23
Tender_8964,6154432,1748744,623085,210895,226231,8963387,45.33,5.47
Tender_8965,1466039,1509381,2963057,906966,358905,7204348,38.0,6.2
Tender_8966,2845467,706050,267159,891424,425477,5135577,46.33,5.37
Tender_8967,2816962,4521819,2734161,796254,55423,10924619,42.67,5.73
Tender_8968,9544111,3340310,2422632,884549,399250,16590852,45.67,5.43
Tender_8969,6960001,3898634,97891,841279,417178,12214983,38.0,6.2
Tender_8970,9976281,1809086,1264839,676906,102215,13829327,30.33,6.97
Tender_8971,5800350,1820312,692648,440429,120023,8873762,41.67,5.83
Tender_8972,2588745,3823393,2832061,506418,492842,10243459,27.67,7.23
Tender_8973,3926695,1344776,2720281,785332,262111,9039195,25.33,7.47
Tender_8974,8609415,3285771,1509234,841142,398093,14643655,36.67,6.33
Tender_8975,2891993,2751183,2281707,352803,55754,8333440,30.33,6.97
Tender_8976,1928538,3723304,1273777,494056,127036,7546711,28.0,7.2
Tender_8977,1025739,4516709,1027132,736834,216928,7523342,57.0,4.3
Tender_8978,7502054,1779481,788651,651722,164366,10886274,50.0,5.0
Tender_8979,2786871,3888738,2722107,716430,132756,10246902,54.33,4.57
Tender_8980,9236038,1524126,2565615,360694,467461,14153934,39.33,6.07
Tender_8981,6605974,556623,2442756,563221,191023,10359597,41.33,5.87
Tender_8982,9470275,610671,427739,784673,339532,11632890,29.67,7.03
Tender_8983,6009608,2523746,837092,983633,201713,10555792,44.67,5.53
Tender_8984,2475293,2739139,2056772,127003,58416,7456623,48.0,5.2
Tender_8985,1854724,645130,2376742,308721,233636,5418953,33.0,6.7
Tender_8986,920210,3402732,207597,781986,356904,5669429,42.0,5.8
Tender_8987,865452,3196595,2061796,94971,445817,6664631,43.0,5.7
Tender_8988,7869179,3090515,2122608,894652,359146,14336100,42.67,5.73
Tender_8989,3958989,637083,614742,528465,112504,5851783,28.67,7.13
Tender_8990,5840277,2850877,703051,886346,183824,10464375,38.33,6.17
Tender_8991,744761,681507,1204681,869852,311244,3812045,22.67,7.73
Tender_8992,1481613,4032615,1100629,200494,64468,6879819,25.33,7.47
Tender_8993,3593668,4643593,508281,69949,361063,9176554,19.67,8.03
Tender_8994,3276363,1323367,1222756,491373,451328,6765187,41.33,5.87
Tender_8995,6108591,3788363,1722770,161402,128308,11909434,32.33,6.77
Tender_8996,7943298,2045312,978995,57085,439407,11464097,45.33,5.47
Tender_8997,582066,1935042,839001,240135,258325,3854569,48.67,5.13
Tender_8998,5303622,2944659,818925,579182,246252,9892640,32.67,6.73
Tender_8999,5015703,547727,1996157,883236,79062,8521885,35.33,6.47
Tender_9000,1618894,1672584,2226870,303339,248046,6069733,49.0,5.1
Tender_9001,4553991,1053482,2373187,339039,195117,8514816,38.0,6.2
Tender_9002,8752371,2668787,1237797,650193,453516,13762664,29.0,7.1
Tender_9003,2603329,1472563,1395521,499883,333833,6305129,16.0,8.4
Tender_9004,2692103,936700,2669174,719623,479754,7497354,24.67,7.53
Tender_9005,4884672,4163361,969012,51546,127919,10196510,19.33,8.07
Tender_9006,3713671,1227799,155391,881564,154948,6133373,28.0,7.2
Tender_9007,507072,834065,1421941,473750,403425,3640253,21.67,7.83
Tender_9008,3274676,4479728,84629,706117,308515,8853665,41.33,5.87
Tender_9009,5893071,4480721,1882119,973158,367446,13596515,31.67,6.83
Tender_9010,5640306,1191532,2614638,738199,246939,10431614,45.0,5.5
Tender_9011,8660984,1943638,2823688,162937,99604,13690851,44.0,5.6
Tender_9012,8960624,3812750,2517295,457129,412267,16160065,30.0,7.0
Tender_9013,9561715,1248185,2375509,835540,165884,14186833,43.67,5.63
Tender_9014,6314293,1374611,2094818,340058,245176,10368956,41.33,5.87
Tender_9015,5667281,2247782,1620084,783243,307990,10626380,50.0,5.0
Tender_9016,7644834,1208992,2270308,630605,321107,12075846,34.0,6.6
Tender_9017,3705872,4385253,1376931,273919,144699,9886674,32.0,6.8
Tender_9018,3893142,1292051,681194,170704,263961,6301052,35.67,6.43
Tender_9019,8392522,1749093,1511722,245178,436570,12335085,45.33,5.47
Tender_9020,4689081,2558866,2098227,260964,94827,9701965,38.67,6.13
Tender_9021,3022907,2255433,751529,82941,413174,6525984,48.67,5.13
Tender_9022,6888309,1295217,1193674,466514,488406,10332120,34.0,6.6
Tender_9023,325587,578185,2545904,582677,343226,4375579,48.67,5.13
Tender_9024,9319460,3782322,701804,127849,151803,14083238,50.67,4.93
Tender_9025,6221674,1112714,1608984,231465,134330,9309167,35.33,6.47
Tender_9026,6154872,1562345,2420177,384637,352971,10875002,25.33,7.47
Tender_9027,945601,1316899,2164159,817847,200080,5444586,40.67,5.93
Tender_9028,2473511,2100437,2019679,581952,92920,7268499,50.0,5.0
Tender_9029,6798168,357847,1801789,985772,88956,10032532,44.33,5.57
Tender_9030,2841461,1417944,1160829,547064,97871,6065169,44.67,5.53
Tender_9031,6486598,2937822,131971,602899,424717,10584007,44.0,5.6
Tender_9032,2036354,1895679,231233,941984,453573,5558823,19.67,8.03
Tender_9033,4660191,200272,2994599,168314,473297,8496673,32.0,6.8
Tender_9034,4186409,131637,1705710,725120,438448,7187324,41.0,5.9
Tender_9035,5516562,4036713,2453545,711011,265563,12983394,35.67,6.43
Tender_9036,3852831,1378353,1834677,990434,327306,8383601,44.33,5.57
Tender_9037,9789094,1986515,1124864,138716,271631,13310820,27.33,7.27
Tender_9038,6252138,1335616,1880037,756508,250778,10475077,37.0,6.3
Tender_9039,5544855,2488789,2624639,113995,385401,11157679,23.33,7.67
Tender_9040,7032489,4686017,153595,885416,465055,13222572,28.33,7.17
Tender_9041,2241031,2396249,526934,187077,370779,5722070,19.33,8.07
Tender_9042,7999979,2357429,1764944,410126,325337,12857815,47.67,5.23
Tender_9043,2911704,2262143,1284901,235546,430819,7125113,33.33,6.67
Tender_9044,444166,2433053,1207225,562649,367409,5014502,48.33,5.17
Tender_9045,8106148,605408,2840206,93090,63671,11708523,48.67,5.13
Tender_9046,1232944,2945418,623876,981062,346358,6129658,43.0,5.7
Tender_9047,4348717,951760,1034299,497452,211825,7044053,40.33,5.97
Tender_9048,7504420,1759681,1948986,916042,364253,12493382,32.33,6.77
Tender_9049,8352299,3857686,90556,719578,496448,13516567,24.0,7.6
Tender_9050,9548774,2460611,382860,153331,232359,12777935,59.33,4.07
Tender_9051,8649101,4663352,2768579,196508,466351,16743891,25.0,7.5
Tender_9052,3613477,4620252,1269087,197400,480304,10180520,41.67,5.83
Tender_9053,8156081,3858086,341795,459515,418836,13234313,47.33,5.27
Tender_9054,3451163,568753,1466448,924389,90052,6500805,46.33,5.37
Tender_9055,6724034,3100367,1583086,87773,276537,11771797,32.67,6.73
Tender_9056,3892685,2932568,326282,762072,317320,8230927,45.67,5.43
Tender_9057,1005608,2238758,234582,488966,433851,4401765,47.67,5.23
Tender_9058,1813912,4534034,1509013,776147,76787,8709893,46.33,5.37
Tender_9059,5989620,200700,513034,149626,478084,7331064,47.33,5.27
Tender_9060,3273699,480993,1899470,351561,498848,6504571,41.0,5.9
Tender_9061,8114296,3099532,2095045,817682,206835,14333390,41.0,5.9
Tender_9062,8309052,4027729,1428096,231673,61729,14058279,48.0,5.2
Tender_9063,3570385,1608086,2020718,312491,230347,7742027,45.67,5.43
Tender_9064,8053940,2860663,2210529,377705,70503,13573340,23.0,7.7
Tender_9065,4946883,1387100,1633080,627183,419239,9013485,33.0,6.7
Tender_9066,9298632,4917284,398185,504147,371496,15489744,39.33,6.07
Tender_9067,1760676,2228756,2771481,335579,138003,7234495,31.67,6.83
Tender_9068,2262239,2669814,690398,135980,421545,6179976,33.67,6.63
Tender_9069,9117745,2027713,1046517,360796,133861,12686632,50.33,4.97
Tender_9070,5247218,541446,1612386,402865,306786,8110701,37.33,6.27
Tender_9071,4814098,4894464,2752810,829544,286757,13577673,34.67,6.53
Tender_9072,9364800,4878279,2918520,937024,138373,18236996,49.33,5.07
Tender_9073,8496136,4453585,2149379,586164,330195,16015459,55.0,4.5
Tender_9074,9157800,1456884,1946518,242111,255357,13058670,30.0,7.0
Tender_9075,9927856,1770507,1638334,287476,278386,13902559,43.67,5.63
Tender_9076,482975,1751860,1655024,115644,180874,4186377,52.67,4.73
Tender_9077,6195614,1277364,717350,260216,493762,8944306,48.33,5.17
Tender_9078,2718914,836370,1701371,967628,457146,6681429,53.0,4.7
Tender_9079,9837664,3031527,2619359,780426,199808,16468784,47.0,5.3
Tender_9080,1891098,1829992,259918,613284,234850,4829142,29.33,7.07
Tender_9081,9304716,1505277,2502211,870069,385042,14567315,36.33,6.37
Tender_9082,4967347,4445217,407577,365975,170619,10356735,56.33,4.37
Tender_9083,5055793,1634753,401954,222965,66405,7381870,28.33,7.17
Tender_9084,1042047,1910669,2622687,637281,54857,6267541,53.67,4.63
Tender_9085,9749743,2141951,1858968,538819,480338,14769819,33.33,6.67
Tender_9086,579659,1375718,1058610,917376,193959,4125322,54.0,4.6
Tender_9087,1224043,508662,739092,977252,308485,3757534,29.67,7.03
Tender_9088,3017808,808279,1028800,258307,73997,5187191,51.67,4.83
Tender_9089,5939149,4339172,1677225,290737,165289,12411572,23.33,7.67
Tender_9090,5593920,3584670,714993,260141,464343,10618067,39.0,6.1
Tender_9091,8855427,1005138,1617024,72554,114501,11664644,31.33,6.87
Tender_9092,7865790,3246621,840089,511804,424470,12888774,46.67,5.33
Tender_9093,8764921,1541523,1889866,517208,349131,13062649,43.0,5.7
Tender_9094,2759048,3419543,2249442,263191,198095,8889319,44.0,5.6
Tender_9095,5636378,2504437,1871641,539021,413264,10964741,40.0,6.0
Tender_9096,7976438,3045208,941369,944997,105805,13013817,34.33,6.57
Tender_9097,3539679,3342938,204539,437194,249464,7773814,41.33,5.87
Tender_9098,2035183,555482,1947046,273502,208368,5019581,58.33,4.17
Tender_9099,3753277,4415863,305073,374985,429671,9278869,40.67,5.93
Tender_9100,572859,456714,553257,573712,427872,2584414,43.33,5.67
Tender_9101,3206729,3939776,2687839,334599,192694,10361637,47.67,5.23
Tender_9102,2826067,4473051,2675409,538318,186280,10699125,35.33,6.47
Tender_9103,723237,3800883,934195,341148,152277,5951740,34.33,6.57
Tender_9104,4084916,1164480,2857484,888278,169267,9164425,60.33,3.97
Tender_9105,7795562,842649,570087,447809,488428,10144535,49.33,5.07
Tender_9106,4324837,636376,2878408,361669,484253,8685543,45.0,5.5
Tender_9107,6007792,1974491,1694664,62082,221387,9960416,53.67,4.63
Tender_9108,5258025,4748725,2387591,207713,338047,12940101,50.0,5.0
Tender_9109,907316,2638792,2371857,252408,481994,6652367,30.0,7.0
Tender_9110,6331372,4179222,2595503,65668,455283,13627048,41.0,5.9
Tender_9111,4105502,615325,1920788,421318,206466,7269399,41.33,5.87
Tender_9112,3572139,2676310,2261323,916020,147621,9573413,46.0,5.4
Tender_9113,4440568,556011,262905,421978,207733,5889195,39.0,6.1
Tender_9114,202875,1626921,1077455,728768,275887,3911906,38.67,6.13
Tender_9115,1809358,1505891,1092990,372151,280733,5061123,35.67,6.43
Tender_9116,7205082,4194350,2827248,777914,438072,15442666,41.33,5.87
Tender_9117,4861374,2296263,612359,134903,80428,7985327,49.67,5.03
Tender_9118,7920096,1752007,1018365,184298,468418,11343184,53.33,4.67
Tender_9119,9311729,177216,463880,170037,460664,10583526,40.33,5.97
Tender_9120,6258960,544335,1828598,214401,338473,9184767,32.33,6.77
Tender_9121,1219908,2021441,1332580,373516,194307,5141752,36.33,6.37
Tender_9122,7185165,4406468,2447458,202347,419200,14660638,50.33,4.97
Tender_9123,725584,1473698,1460713,595571,214278,4469844,22.0,7.8
Tender_9124,4038554,3194842,2289757,994407,56203,10573763,33.33,6.67
Tender_9125,3521697,3188117,1734170,272264,194001,8910249,45.0,5.5
Tender_9126,8580053,1999352,1120880,399330,174081,12273696,44.67,5.53
Tender_9127,1358690,3302526,2458126,845183,305985,8270510,54.33,4.57
Tender_9128,9195230,1991800,376370,719467,475045,12757912,44.67,5.53
Tender_9129,6583901,767835,2120067,676106,153777,10301686,43.67,5.63
Tender_9130,6123612,3014187,203782,708883,303234,10353698,38.33,6.17
Tender_9131,8685403,3979245,1400048,316750,86262,14467708,25.33,7.47
Tender_9132,5560811,2077013,2352128,462772,394938,10847662,43.67,5.63
Tender_9133,1390320,3924723,113313,120574,116237,5665167,28.67,7.13
Tender_9134,554670,463261,952254,112369,221797,2304351,41.33,5.87
Tender_9135,2391449,1967385,282134,740212,257911,5639091,39.0,6.1
Tender_9136,1367675,4762798,2075615,482277,499145,9187510,38.67,6.13
Tender_9137,5046734,4593298,445145,63499,351831,10500507,21.67,7.83
Tender_9138,6922666,2942394,1269600,994519,429426,12558605,52.33,4.77
Tender_9139,5612222,3881967,1803113,889419,335905,12522626,35.33,6.47
Tender_9140,4564902,3803734,221932,705756,94102,9390426,27.0,7.3
Tender_9141,9220352,1177776,521049,174525,101685,11195387,49.0,5.1
Tender_9142,1968925,3591258,202476,987576,55739,6805974,57.0,4.3
Tender_9143,9660438,132730,2648092,344613,420699,13206572,32.0,6.8
Tender_9144,3649639,1812601,2624812,101939,181991,8370982,54.0,4.6
Tender_9145,3109205,1901935,1507701,303656,296251,7118748,47.33,5.27
Tender_9146,2997651,1682697,2206078,292434,385680,7564540,31.67,6.83
Tender_9147,570982,3259789,2036150,453975,201837,6522733,38.0,6.2
Tender_9148,6766873,325911,754071,569782,475247,8891884,54.67,4.53
Tender_9149,1325213,3647709,1170532,497797,332197,6973448,51.33,4.87
Tender_9150,6121814,1726217,1294580,671075,477382,10291068,44.0,5.6
Tender_9151,3062091,2992431,314407,795744,227487,7392160,40.0,6.0
Tender_9152,5510004,4945911,417849,167332,174343,11215439,19.67,8.03
Tender_9153,698862,4834081,2685841,192969,452860,8864613,42.0,5.8
Tender_9154,1535311,330359,383047,282694,105830,2637241,25.67,7.43
Tender_9155,1525912,3311740,1066525,417725,317625,6639527,46.0,5.4
Tender_9156,7542641,3776642,2451835,758568,117095,14646781,23.67,7.63
Tender_9157,8292503,220089,2073784,894794,208134,11689304,41.0,5.9
Tender_9158,8759832,1246046,1024593,518932,414891,11964294,48.67,5.13
Tender_9159,7620395,1950700,96790,651192,267776,10586853,36.33,6.37
Tender_9160,9663958,949945,938145,160365,466078,12178491,44.0,5.6
Tender_9161,5463050,3937212,373632,891267,416543,11081704,28.33,7.17
Tender_9162,550214,2873795,311502,80025,483519,4299055,44.67,5.53
Tender_9163,5216416,476882,1600234,60545,297551,7651628,43.67,5.63
Tender_9164,8019510,4522235,457227,716153,81717,13796842,36.0,6.4
Tender_9165,732119,930307,2468842,246855,103395,4481518,37.33,6.27
Tender_9166,391889,237574,1666702,255702,289618,2841485,20.67,7.93
Tender_9167,6917366,2789092,2290337,152124,313778,12462697,32.67,6.73
Tender_9168,3277734,2148097,401345,466712,344048,6637936,45.33,5.47
Tender_9169,2555744,2872047,1353409,992896,102026,7876122,37.67,6.23
Tender_9170,5609825,1235202,1850755,524596,171350,9391728,43.33,5.67
Tender_9171,941314,969314,2498662,795518,471559,5676367,24.33,7.57
Tender_9172,1474698,3743070,2956340,863217,237408,9274733,39.33,6.07
Tender_9173,7777003,1589327,527965,439223,378912,10712430,43.33,5.67
Tender_9174,8478904,1175187,89552,988967,188388,10920998,27.67,7.23
Tender_9175,5787693,4935630,1913862,794089,164037,13595311,39.33,6.07
Tender_9176,1503176,3521981,1657169,847385,121285,7650996,37.67,6.23
Tender_9177,7999096,3098161,1153280,829163,91686,13171386,39.0,6.1
Tender_9178,4929035,1207169,1044437,689499,329997,8200137,34.33,6.57
Tender_9179,9367279,1422275,670035,59296,496496,12015381,38.33,6.17
Tender_9180,824955,972216,1735712,464178,453933,4450994,33.67,6.63
Tender_9181,3184055,1020687,917473,236544,88549,5447308,35.33,6.47
Tender_9182,3542298,4914648,491848,85456,481287,9515537,32.67,6.73
Tender_9183,9644353,4527382,1239218,565037,119500,16095490,35.67,6.43
Tender_9184,3908636,3606413,829247,972919,270441,9587656,40.67,5.93
Tender_9185,7058028,2720854,1147098,58321,202385,11186686,43.67,5.63
Tender_9186,486780,2377159,972120,648762,108817,4593638,40.33,5.97
Tender_9187,5370751,4083106,2307815,821469,232028,12815169,38.33,6.17
Tender_9188,4906434,801279,648813,600366,72652,7029544,38.67,6.13
Tender_9189,8333666,1722127,2708221,459217,288923,13512154,37.67,6.23
Tender_9190,500755,2015844,673308,521449,371159,4082515,31.0,6.9
Tender_9191,7985775,2429568,1131075,892355,222168,12660941,39.67,6.03
Tender_9192,519281,811559,1208851,764598,264185,3568474,27.0,7.3
Tender_9193,7237243,4457874,835931,652894,306745,13490687,42.33,5.77
Tender_9194,7467366,1014801,2457642,398405,450653,11788867,48.67,5.13
Tender_9195,1058604,1435843,1456901,140014,480016,4571378,23.67,7.63
Tender_9196,6219936,930478,491099,361143,239170,8241826,47.0,5.3
Tender_9197,8471664,3254762,1621798,261216,382465,13991905,33.67,6.63
Tender_9198,6578041,4642751,1058015,796981,383034,13458822,30.67,6.93
Tender_9199,5588939,3469902,2341624,115728,293105,11809298,42.33,5.77
Tender_9200,2347394,526286,1296491,471860,274148,4916179,44.0,5.6
Tender_9201,8128488,3274119,450556,441584,348070,12642817,32.33,6.77
Tender_9202,3650907,1618070,225169,781862,456037,6732045,45.0,5.5
Tender_9203,9891071,2827899,790428,577622,86481,14173501,53.0,4.7
Tender_9204,9552211,1894454,1357615,428766,486597,13719643,31.0,6.9
Tender_9205,4332860,3598561,175791,382123,411071,8900406,48.67,5.13
Tender_9206,1384441,699573,2571229,822315,143911,5621469,49.67,5.03
Tender_9207,1801768,1830320,2067597,850582,74296,6624563,42.33,5.77
Tender_9208,2878002,4454979,1363961,949016,104811,9750769,34.0,6.6
Tender_9209,5657476,903783,820163,978035,167897,8527354,48.33,5.17
Tender_9210,8647822,4452388,1706746,870260,222717,15899933,41.0,5.9
Tender_9211,2864447,2367484,159229,903522,316572,6611254,21.67,7.83
Tender_9212,2535856,4411740,2942147,567342,163142,10620227,42.33,5.77
Tender_9213,1635619,3897769,1715180,911783,201899,8362250,38.67,6.13
Tender_9214,8847023,4509513,1773454,767119,134336,16031445,43.0,5.7
Tender_9215,9190878,3286027,1596799,514481,125136,14713321,46.33,5.37
Tender_9216,7732010,4289470,2949366,417852,349785,15738483,48.33,5.17
Tender_9217,342703,4044218,1179781,369441,316453,6252596,42.33,5.77
Tender_9218,2044298,3997960,955712,883461,125076,8006507,43.67,5.63
Tender_9219,7445008,717798,566813,338630,250393,9318642,23.33,7.67
Tender_9220,2816077,724263,466947,639495,460124,5106906,45.33,5.47
Tender_9221,5084475,353427,985167,177654,406696,7007419,42.67,5.73
Tender_9222,4473415,4976639,2732032,712571,363331,13257988,49.33,5.07
Tender_9223,4706760,475603,58494,828319,264061,6333237,22.33,7.77
Tender_9224,5968589,2134533,2661563,445080,100749,11310514,19.67,8.03
Tender_9225,1383133,1765062,1769838,94152,361052,5373237,29.67,7.03
Tender_9226,6840205,1456388,1052163,752708,392576,10494040,17.33,8.27
Tender_9227,7101843,189026,1900769,508976,218915,9919529,40.33,5.97
Tender_9228,1581964,3900412,2061466,141282,378202,8063326,47.67,5.23
Tender_9229,3809879,3437509,1285055,564993,139343,9236779,30.67,6.93
Tender_9230,8395010,1612854,312030,223397,224303,10767594,35.67,6.43
Tender_9231,443682,3154960,2846807,832929,183952,7462330,39.0,6.1
Tender_9232,4288048,4138682,2678513,133726,246353,11485322,47.33,5.27
Tender_9233,4588978,1885997,394702,421924,325374,7616975,23.33,7.67
Tender_9234,696461,825027,2599445,477765,280925,4879623,20.0,8.0
Tender_9235,9280074,3338194,1157887,478805,123636,14378596,51.0,4.9
Tender_9236,4924262,3209880,773654,252697,316212,9476705,51.67,4.83
Tender_9237,8167669,3706038,723933,667050,102287,13366977,45.67,5.43
Tender_9238,8938905,1363224,2180448,498676,150969,13132222,47.0,5.3
Tender_9239,5622663,4745715,1552127,237896,276058,12434459,48.33,5.17
Tender_9240,3970540,2797970,598310,527684,116990,8011494,52.33,4.77
Tender_9241,2244216,4821026,779394,673754,127226,8645616,46.67,5.33
Tender_9242,5530830,803279,205574,428372,280727,7248782,40.67,5.93
Tender_9243,944536,3505398,1355994,334559,272284,6412771,47.33,5.27
Tender_9244,2530078,681075,891913,737792,294694,5135552,33.67,6.63
Tender_9245,7840813,3107195,1029963,704588,352299,13034858,32.0,6.8
Tender_9246,5087600,4660715,84857,258935,139456,10231563,35.67,6.43
Tender_9247,4260976,1364872,2721599,111097,284471,8743015,33.33,6.67
Tender_9248,9648655,324096,74138,357230,424049,10828168,29.33,7.07
Tender_9249,4290807,870253,1677179,106455,351417,7296111,43.67,5.63
Tender_9250,2143485,241335,778682,752551,73625,3989678,38.67,6.13
Tender_9251,9638302,193897,1022229,500027,401632,11756087,40.0,6.0
Tender_9252,1898288,2075054,300648,826266,226967,5327223,51.67,4.83
Tender_9253,6577445,3692611,1383327,899110,184730,12737223,49.33,5.07
Tender_9254,6112212,3723787,175619,349901,88054,10449573,32.33,6.77
Tender_9255,4854154,4022847,1180147,636437,160750,10854335,42.67,5.73
Tender_9256,5485073,2846092,1893729,876876,148318,11250088,46.33,5.37
Tender_9257,4915097,4600230,2325077,519081,110978,12470463,44.0,5.6
Tender_9258,9259385,440678,634958,130346,280395,10745762,45.33,5.47
Tender_9259,599295,4649100,2019886,61585,357499,7687365,36.67,6.33
Tender_9260,7082444,1617318,2102775,199919,438505,11440961,26.67,7.33
Tender_9261,2458083,4108638,872298,545026,198164,8182209,34.67,6.53
Tender_9262,1119148,2026984,1337823,825953,441322,5751230,40.0,6.0
Tender_9263,9898713,1943627,1498926,50006,275030,13666302,50.67,4.93
Tender_9264,5505213,4206768,1992822,332150,130439,12167392,51.33,4.87
Tender_9265,2399905,3921107,2997620,692377,177347,10188356,44.33,5.57
Tender_9266,8499116,3877573,891984,267140,475537,14011350,44.0,5.6
Tender_9267,5809575,1813731,2709679,748154,327483,11408622,55.33,4.47
Tender_9268,8596350,691001,1238537,834521,176597,11537006,47.33,5.27
Tender_9269,6826104,3008104,1827789,649368,408544,12719909,47.33,5.27
Tender_9270,1197421,4466629,2868155,450607,263950,9246762,18.67,8.13
Tender_9271,7736632,1693150,1377045,918003,381747,12106577,42.0,5.8
Tender_9272,2833924,3504894,662823,893456,157397,8052494,40.0,6.0
Tender_9273,6135844,2821279,1865018,756066,264597,11842804,43.0,5.7
Tender_9274,1219046,4063562,2066553,336145,352985,8038291,43.67,5.63
Tender_9275,3388067,2488853,2787145,156788,497993,9318846,42.67,5.73
Tender_9276,3389462,4437394,2866497,155286,51208,10899847,31.0,6.9
Tender_9277,3883878,2922343,1359749,544090,229697,8939757,44.33,5.57
Tender_9278,561031,4400799,2646484,549318,50685,8208317,17.33,8.27
Tender_9279,2690325,3492144,2560767,732695,304626,9780557,33.0,6.7
Tender_9280,1042263,4471021,2366802,320745,165011,8365842,32.0,6.8
Tender_9281,7204709,2949068,2216865,354295,85057,12809994,22.33,7.77
Tender_9282,9375780,4636380,1066911,692934,212523,15984528,38.0,6.2
Tender_9283,3315499,4052096,1469123,344097,192469,9373284,48.0,5.2
Tender_9284,2590619,2013650,428642,87222,437420,5557553,36.33,6.37
Tender_9285,423931,1652875,2658455,178577,99158,5012996,27.67,7.23
Tender_9286,5589182,3164720,2569420,906033,124019,12353374,42.67,5.73
Tender_9287,3801428,4093904,573520,302028,63025,8833905,27.33,7.27
Tender_9288,8759986,2576461,1937245,448901,202882,13925475,43.0,5.7
Tender_9289,4940629,2701137,1904938,139198,280181,9966083,32.33,6.77
Tender_9290,5850405,2029995,1085643,480213,206359,9652615,29.33,7.07
Tender_9291,2913326,1966039,2007596,929819,261454,8078234,24.0,7.6
Tender_9292,9522923,4608566,1857371,92866,180735,16262461,40.33,5.97
Tender_9293,2069844,4024859,1750949,532774,361887,8740313,36.33,6.37
Tender_9294,3665906,1399619,108486,382737,222819,5779567,28.67,7.13
Tender_9295,4398763,1691696,1847364,641273,144810,8723906,28.33,7.17
Tender_9296,9812365,2212881,745203,698783,184284,13653516,34.33,6.57
Tender_9297,8058436,962507,1597666,172651,494498,11285758,33.33,6.67
Tender_9298,8831505,2225160,2552894,155057,261572,14026188,39.0,6.1
Tender_9299,5514934,1333008,909449,886853,472255,9116499,40.67,5.93
Tender_9300,7698516,1909787,1972881,79835,380817,12041836,56.67,4.33
Tender_9301,5547992,4941008,2111626,913672,390511,13904809,36.67,6.33
Tender_9302,2712661,1013997,721094,109362,252633,4809747,36.33,6.37
Tender_9303,3948490,770878,1250136,800349,150154,6920007,32.67,6.73
Tender_9304,2629533,4901118,1386357,788751,429723,10135482,36.0,6.4
Tender_9305,6528572,3634711,1936130,74495,125572,12299480,42.33,5.77
Tender_9306,6517356,4308473,1230471,118884,94423,12269607,32.0,6.8
Tender_9307,1639819,3609213,1159015,884561,451564,7744172,39.67,6.03
Tender_9308,742893,1663929,542204,201016,254478,3404520,18.0,8.2
Tender_9309,3720074,1046220,1516951,830068,60292,7173605,39.33,6.07
Tender_9310,9426889,909189,931019,999628,159396,12426121,42.33,5.77
Tender_9311,2808479,2098221,2624770,949369,313191,8794030,27.33,7.27
Tender_9312,2095082,4204333,1625237,614887,51549,8591088,45.67,5.43
Tender_9313,2194788,3154826,1711170,274841,321412,7657037,21.67,7.83
Tender_9314,8999102,3694301,188785,730716,50413,13663317,39.67,6.03
Tender_9315,7126788,2465181,2260100,511151,283839,12647059,21.0,7.9
Tender_9316,3104571,4299002,1768381,90795,163671,9426420,44.0,5.6
Tender_9317,325011,4627193,235231,207431,470149,5865015,42.33,5.77
Tender_9318,5561147,3892779,1333813,416202,256395,11460336,53.67,4.63
Tender_9319,922331,1567580,2191356,812678,385962,5879907,41.33,5.87
Tender_9320,2350905,382722,2555546,477790,397914,6164877,40.0,6.0
Tender_9321,6442165,3263774,2463671,233510,218556,12621676,33.33,6.67
Tender_9322,5553255,4264059,1115231,83606,102054,11118205,45.67,5.43
Tender_9323,1304317,4005376,71700,199585,94167,5675145,43.67,5.63
Tender_9324,4264252,1506842,2721253,782862,160166,9435375,26.67,7.33
Tender_9325,986945,1774525,370001,611987,152498,3895956,25.67,7.43
Tender_9326,9659685,4813170,2396231,903734,133719,17906539,35.33,6.47
Tender_9327,6779527,2461013,1587681,293036,291004,11412261,40.67,5.93
Tender_9328,3094029,1378318,419069,901336,189388,5982140,41.67,5.83
Tender_9329,5185227,4398011,1282444,431576,188827,11486085,29.67,7.03
Tender_9330,3220970,781293,2477755,473994,367399,7321411,23.0,7.7
Tender_9331,7034853,4407080,1835315,184912,296522,13758682,50.67,4.93
Tender_9332,5077989,1552751,2341177,714236,385463,10071616,42.67,5.73
Tender_9333,8558485,3431099,1978289,106977,244768,14319618,43.33,5.67
Tender_9334,8445006,3156493,865926,362689,70608,12900722,31.33,6.87
Tender_9335,477589,2524129,1700511,279469,112693,5094391,38.67,6.13
Tender_9336,8168115,4973230,2327448,794277,209938,16473008,45.33,5.47
Tender_9337,542461,262850,2997764,579528,324636,4707239,44.67,5.53
Tender_9338,3869976,608900,2593460,660205,147682,7880223,42.67,5.73
Tender_9339,5092423,724527,1294015,721485,444799,8277249,29.67,7.03
Tender_9340,5866825,339664,1377920,413071,97677,8095157,45.67,5.43
Tender_9341,6539446,1990396,1652277,105441,442213,10729773,35.67,6.43
Tender_9342,3128609,4498732,414302,109648,312451,8463742,25.67,7.43
Tender_9343,1412238,216561,2215457,400219,329869,4574344,41.0,5.9
Tender_9344,6172138,939385,2591163,338215,71129,10112030,29.33,7.07
Tender_9345,6228319,1605519,2853825,121900,414965,11224528,27.0,7.3
Tender_9346,5745092,899559,319948,279391,460740,7704730,28.67,7.13
Tender_9347,2493146,4824974,1034112,121113,347225,8820570,45.33,5.47
Tender_9348,8336999,1232064,1248019,457711,280989,11555782,38.67,6.13
Tender_9349,4495186,2256843,2646908,382986,370992,10152915,23.33,7.67
Tender_9350,2770495,2531665,879041,601805,68360,6851366,28.0,7.2
Tender_9351,2046341,3484264,437632,799681,382894,7150812,39.33,6.07
Tender_9352,6901043,1852452,1653098,536642,85128,11028363,34.33,6.57
Tender_9353,9757620,1771169,2025991,870388,191459,14616627,35.67,6.43
Tender_9354,1928425,595568,1596478,174498,494164,4789133,39.67,6.03
Tender_9355,6185049,1523461,1407946,208687,177719,9502862,30.33,6.97
Tender_9356,8336727,4898981,2975161,98916,308615,16618400,26.33,7.37
Tender_9357,6160341,3840125,177170,420958,180113,10778707,33.0,6.7
Tender_9358,9717588,2010931,2740084,106199,434380,15009182,51.33,4.87
Tender_9359,5308450,4898717,923515,165022,454341,11750045,32.67,6.73
Tender_9360,2123376,4971932,2812520,186604,240346,10334778,46.33,5.37
Tender_9361,9729440,2959265,498781,204015,286983,13678484,39.67,6.03
Tender_9362,456051,4930834,53397,745308,191295,6376885,16.67,8.33
Tender_9363,4409123,1390065,2617087,264082,56771,8737128,36.67,6.33
Tender_9364,5614869,4209958,886678,972339,55751,11739595,39.33,6.07
Tender_9365,4632707,2657316,2270416,192315,383549,10136303,38.0,6.2
Tender_9366,9837651,491695,2335291,556428,102865,13323930,50.33,4.97
Tender_9367,1023632,1786350,2205843,134390,119756,5269971,40.0,6.0
Tender_9368,7494227,2007445,816714,813484,131823,11263693,27.33,7.27
Tender_9369,5605419,1434286,2642994,288065,274784,10245548,25.33,7.47
Tender_9370,5251370,706245,1575439,208942,168447,7910443,32.0,6.8
Tender_9371,8535847,2055611,1636683,73753,171874,12473768,43.67,5.63
Tender_9372,9026869,1371073,853769,678395,466042,12396148,23.33,7.67
Tender_9373,2657774,4523238,1959217,114091,400695,9655015,31.0,6.9
Tender_9374,2662641,1845424,2640137,850917,75390,8074509,36.0,6.4
Tender_9375,5245333,454035,2032675,374624,63625,8170292,29.33,7.07
Tender_9376,1140614,3541258,1005771,907646,445262,7040551,39.0,6.1
Tender_9377,8618630,4559779,1723817,452343,90150,15444719,36.33,6.37
Tender_9378,8974164,2291705,2085212,453860,365854,14170795,33.67,6.63
Tender_9379,6694481,429764,2273175,771048,455556,10624024,48.67,5.13
Tender_9380,7373010,576975,2434102,980534,430023,11794644,37.0,6.3
Tender_9381,6964189,2772308,2849743,174586,136132,12896958,31.33,6.87
Tender_9382,1438253,867041,2229173,195580,359448,5089495,39.33,6.07
Tender_9383,2012038,2840334,2390675,698403,438168,8379618,47.0,5.3
Tender_9384,9059758,3330182,134988,470311,425724,13420963,37.33,6.27
Tender_9385,7650065,1817407,454993,918365,342965,11183795,33.33,6.67
Tender_9386,1164508,4890847,2506859,304577,326869,9193660,30.67,6.93
Tender_9387,423969,1940379,1771586,128251,72382,4336567,43.67,5.63
Tender_9388,7553657,3170752,735548,941326,376674,12777957,35.33,6.47
Tender_9389,4720104,1141876,772975,125062,124881,6884898,31.33,6.87
Tender_9390,9499838,2084187,903008,433281,338807,13259121,31.67,6.83
Tender_9391,412791,110549,448931,463124,319007,1754402,32.67,6.73
Tender_9392,424745,2056921,1155085,653369,412150,4702270,33.0,6.7
Tender_9393,7171712,2670792,594355,547887,485720,11470466,38.67,6.13
Tender_9394,1732974,4879308,481807,155910,118036,7368035,34.33,6.57
Tender_9395,9434241,1263842,466945,801917,69377,12036322,31.67,6.83
Tender_9396,861733,457692,2827246,544072,70614,4761357,20.0,8.0
Tender_9397,2765038,664742,794864,780698,237670,5243012,34.67,6.53
Tender_9398,741743,1689277,1436011,124225,222143,4213399,18.67,8.13
Tender_9399,3381389,1679005,1063795,485630,62699,6672518,29.67,7.03
Tender_9400,2127186,520118,1185072,186099,334899,4353374,36.33,6.37
Tender_9401,6466933,1816691,93354,487995,235002,9099975,40.67,5.93
Tender_9402,6401575,2699318,1198310,573327,257031,11129561,25.67,7.43
Tender_9403,7446941,1354104,1144835,991192,371633,11308705,37.33,6.27
Tender_9404,7995573,1523856,1185884,634766,97869,11437948,38.33,6.17
Tender_9405,7948908,4653112,2701396,186573,312570,15802559,46.0,5.4
Tender_9406,5518010,4912648,1281310,987932,279659,12979559,46.0,5.4
Tender_9407,3314267,4923488,51846,908894,478071,9676566,48.0,5.2
Tender_9408,2132499,2907649,1970556,132251,418453,7561408,36.33,6.37
Tender_9409,7093544,893673,594038,334166,404988,9320409,18.67,8.13
Tender_9410,3478173,4741735,422354,421749,242811,9306822,46.33,5.37
Tender_9411,6364728,1470480,356091,731509,448959,9371767,53.33,4.67
Tender_9412,2839612,2529095,567605,453726,370911,6760949,39.67,6.03
Tender_9413,4505256,1984058,786120,539162,383316,8197912,55.33,4.47
Tender_9414,4901901,1156297,1389545,820911,491620,8760274,38.67,6.13
Tender_9415,5253428,3201958,2510268,344944,189231,11499829,51.0,4.9
Tender_9416,6161928,3323100,1636688,801584,248267,12171567,33.67,6.63
Tender_9417,683398,2945883,1716583,523316,147625,6016805,48.67,5.13
Tender_9418,7759612,227078,1946793,962670,268259,11164412,45.67,5.43
Tender_9419,7489089,4918583,2457591,394004,87964,15347231,55.67,4.43
Tender_9420,5621743,2492236,1530482,87243,162883,9894587,35.67,6.43
Tender_9421,5343231,4706842,1773067,226962,137354,12187456,45.33,5.47
Tender_9422,7858617,2566089,461032,475355,127859,11488952,40.0,6.0
Tender_9423,9056895,3534262,569644,178505,104791,13444097,36.67,6.33
Tender_9424,8791793,2565188,937538,741548,277998,13314065,50.67,4.93
Tender_9425,9887411,3118898,2610565,425670,466324,16508868,28.0,7.2
Tender_9426,1834826,3125646,851701,596432,326481,6735086,46.33,5.37
Tender_9427,5512434,3634524,1523279,487398,145148,11302783,46.0,5.4
Tender_9428,6431399,157878,1056374,163289,328570,8137510,48.67,5.13
Tender_9429,4245787,1895711,233205,629542,57333,7061578,32.33,6.77
Tender_9430,9181623,1734574,345619,706838,404181,12372835,39.0,6.1
Tender_9431,8023299,3444914,2491549,445806,344909,14750477,27.33,7.27
Tender_9432,8439745,3045002,958821,124987,92944,12661499,34.0,6.6
Tender_9433,6283064,2446968,1737589,822955,249145,11539721,48.0,5.2
Tender_9434,2171912,2765601,959264,930980,143196,6970953,36.0,6.4
Tender_9435,5357560,2156333,948110,299994,99976,8861973,33.33,6.67
Tender_9436,2437321,1144803,2479684,370232,297633,6729673,32.67,6.73
Tender_9437,5553908,2966074,1448801,969191,175904,11113878,50.67,4.93
Tender_9438,8590745,4109914,2530385,520661,427476,16179181,47.0,5.3
Tender_9439,553151,2675256,2093276,121734,58926,5502343,56.33,4.37
Tender_9440,8541775,2161511,1576319,571675,52004,12903284,27.0,7.3
Tender_9441,5162211,2622038,2047323,471225,133692,10436489,43.0,5.7
Tender_9442,2633332,4029822,2039034,708375,287918,9698481,56.0,4.4
Tender_9443,2861989,4124494,2162975,147800,86593,9383851,17.33,8.27
Tender_9444,2115452,3208335,2570881,741917,477694,9114279,39.33,6.07
Tender_9445,2909019,3614629,2078396,254347,173439,9029830,32.0,6.8
Tender_9446,221114,2567928,2913950,949367,200365,6852724,27.67,7.23
Tender_9447,3420970,2162744,2117160,524676,444516,8670066,39.33,6.07
Tender_9448,8068920,1398233,1670241,996062,279270,12412726,43.0,5.7
Tender_9449,3781948,4082074,476868,653330,117250,9111470,33.67,6.63
Tender_9450,7138409,1806148,755564,624108,434046,10758275,49.33,5.07
Tender_9451,404141,1754449,1885771,917875,225505,5187741,45.0,5.5
Tender_9452,385648,1393435,1808592,618358,178098,4384131,23.67,7.63
Tender_9453,1981151,4998294,1561246,868774,332511,9741976,32.67,6.73
Tender_9454,5266338,3281364,523448,803736,194755,10069641,37.33,6.27
Tender_9455,5603084,559445,1126641,484266,200536,7973972,50.0,5.0
Tender_9456,3331081,2430613,2954645,961775,165468,9843582,32.33,6.77
Tender_9457,4259551,2116932,2548307,882673,277199,10084662,23.67,7.63
Tender_9458,3167475,1548297,720992,537279,276559,6250602,54.0,4.6
Tender_9459,4297883,606068,1354854,923965,223714,7406484,35.0,6.5
Tender_9460,2398667,3653286,503229,359149,495995,7410326,36.67,6.33
Tender_9461,2031440,1089457,80706,979513,127191,4308307,38.0,6.2
Tender_9462,5034511,859007,303118,313616,442418,6952670,60.33,3.97
Tender_9463,2443791,1389276,2463864,883980,79733,7260644,45.67,5.43
Tender_9464,767767,1109091,1768508,663488,183121,4491975,49.33,5.07
Tender_9465,4630693,3915632,2583449,860640,105601,12096015,46.0,5.4
Tender_9466,1887449,175982,197931,424468,52749,2738579,39.67,6.03
Tender_9467,8378649,2370590,131886,678421,443908,12003454,40.67,5.93
Tender_9468,3759874,1888565,1191178,551895,142568,7534080,54.0,4.6
Tender_9469,9807828,4074721,405989,278180,260220,14826938,40.67,5.93
Tender_9470,5703402,4915043,2197145,513151,321885,13650626,48.67,5.13
Tender_9471,3884486,3631008,334171,632767,59560,8541992,41.33,5.87
Tender_9472,8773775,3036076,2700255,496535,166782,15173423,45.67,5.43
Tender_9473,5093423,315703,1060521,741281,180019,7390947,38.67,6.13
Tender_9474,3424666,4784331,1782189,226139,483503,10700828,33.0,6.7
Tender_9475,450357,2465267,1756750,475136,67140,5214650,26.33,7.37
Tender_9476,8310980,1779253,654459,419100,382845,11546637,46.67,5.33
Tender_9477,1387357,1686235,197539,774004,289101,4334236,38.0,6.2
Tender_9478,8766620,3976563,1768122,670824,446554,15628683,26.0,7.4
Tender_9479,5296857,1203595,1667984,176570,250251,8595257,31.0,6.9
Tender_9480,7086739,2201048,1838207,949082,427267,12502343,49.33,5.07
Tender_9481,7431663,1000964,415321,178615,370339,9396902,31.67,6.83
Tender_9482,395004,3885564,79459,551855,235515,5147397,47.0,5.3
Tender_9483,627390,2679989,759580,683778,73061,4823798,39.67,6.03
Tender_9484,4288898,467259,215251,701197,59308,5731913,43.33,5.67
Tender_9485,5742664,3802294,388478,459192,343836,10736464,42.67,5.73
Tender_9486,2046985,4714349,435548,254480,294064,7745426,44.0,5.6
Tender_9487,4718847,1464580,2989971,645769,139961,9959128,30.33,6.97
Tender_9488,1052238,4162542,1941648,136208,425648,7718284,41.0,5.9
Tender_9489,3694439,3554492,1194808,122387,175495,8741621,43.33,5.67
Tender_9490,3864299,4663131,1585296,559677,157681,10830084,36.33,6.37
Tender_9491,4103087,935014,525388,676069,487523,6727081,29.67,7.03
Tender_9492,1830196,4132545,2875638,230737,414145,9483261,59.67,4.03
Tender_9493,4346009,1036868,2167787,723180,346836,8620680,40.0,6.0
Tender_9494,9749397,3609074,2757572,278598,245493,16640134,41.33,5.87
Tender_9495,3473753,2508676,2278031,792139,104687,9157286,48.0,5.2
Tender_9496,6597798,1316575,2505177,617095,299186,11335831,34.33,6.57
Tender_9497,797709,554921,1078435,575292,330811,3337168,46.0,5.4
Tender_9498,6168134,4174459,1156568,583114,419641,12501916,51.67,4.83
Tender_9499,8139860,2219662,1923492,295026,389832,12967872,22.33,7.77
Tender_9500,2687326,1995015,1972876,337328,343575,7336120,38.67,6.13
Tender_9501,1084732,4030095,978698,68676,59833,6222034,24.67,7.53
Tender_9502,7761164,2747132,345513,753001,435601,12042411,29.33,7.07
Tender_9503,3580287,709819,291818,241364,83951,4907239,53.33,4.67
Tender_9504,1688780,3961364,493946,742038,186823,7072951,26.33,7.37
Tender_9505,1392636,4085243,381542,706784,496410,7062615,51.0,4.9
Tender_9506,6260181,4217009,180236,440225,156718,11254369,50.0,5.0
Tender_9507,7125771,4372985,1752844,579181,90365,13921146,47.67,5.23
Tender_9508,8414509,2669815,264801,454849,141588,11945562,52.67,4.73
Tender_9509,7121239,1211862,61919,221790,463915,9080725,47.0,5.3
Tender_9510,3137812,3167797,1019593,478740,410743,8214685,44.0,5.6
Tender_9511,4192941,1086659,75306,271559,129283,5755748,17.67,8.23
Tender_9512,8636123,470696,2277810,607135,121414,12113178,42.33,5.77
Tender_9513,7371264,4790515,1448770,80337,480333,14171219,43.0,5.7
Tender_9514,6221262,844225,2500717,591185,331101,10488490,46.67,5.33
Tender_9515,9124857,3730202,2036010,897201,312983,16101253,34.0,6.6
Tender_9516,2424916,2947904,988811,448843,107884,6918358,27.33,7.27
Tender_9517,6995888,4321438,2074025,688425,365718,14445494,39.0,6.1
Tender_9518,4130575,4684930,233949,222209,340537,9612200,51.0,4.9
Tender_9519,638740,4152524,1681263,528683,117919,7119129,51.0,4.9
Tender_9520,1819940,4790499,532408,298594,457782,7899223,36.67,6.33
Tender_9521,6518377,3830662,786515,988481,257994,12382029,45.67,5.43
Tender_9522,1502024,743083,1217656,184000,199239,3846002,33.0,6.7
Tender_9523,8653537,663738,1424099,169492,420243,11331109,26.33,7.37
Tender_9524,1150077,4891925,1591084,65077,116160,7814323,54.67,4.53
Tender_9525,3369534,3404947,1528888,760167,233777,9297313,38.33,6.17
Tender_9526,777319,4101123,537416,839208,324475,6579541,36.0,6.4
Tender_9527,3810286,2279979,2480191,601290,128175,9299921,42.33,5.77
Tender_9528,8986448,4226633,1589005,528157,275133,15605376,49.67,5.03
Tender_9529,7545845,3908953,319103,299786,128573,12202260,38.0,6.2
Tender_9530,9942777,2960728,981940,547523,196944,14629912,34.33,6.57
Tender_9531,4805418,1917646,584398,522721,195070,8025253,35.0,6.5
Tender_9532,2844828,761675,730211,875530,395598,5607842,42.33,5.77
Tender_9533,6875002,3311855,2758684,362554,459254,13767349,52.33,4.77
Tender_9534,3743030,1338606,608833,231456,325728,6247653,28.33,7.17
Tender_9535,4941601,4020420,1817692,723203,255805,11758721,19.67,8.03
Tender_9536,328325,4130022,1864366,358046,149992,6830751,35.67,6.43
Tender_9537,6145220,458392,1447029,374512,364561,8789714,45.33,5.47
Tender_9538,5146869,3714902,229355,869945,381352,10342423,37.0,6.3
Tender_9539,8472475,3285242,2575170,306494,317280,14956661,43.67,5.63
Tender_9540,6201899,4880403,2318792,900823,421817,14723734,53.0,4.7
Tender_9541,6449225,3200805,158729,384080,423968,10616807,39.67,6.03
Tender_9542,1420489,3044779,558260,971785,279962,6275275,33.0,6.7
Tender_9543,5780881,804652,2056773,988233,296630,9927169,38.0,6.2
Tender_9544,6945098,2927777,2711480,496685,423220,13504260,23.0,7.7
Tender_9545,8926209,2496799,274388,363572,100868,12161836,24.0,7.6
Tender_9546,3973970,600404,2676284,590655,215346,8056659,27.67,7.23
Tender_9547,2827551,2175913,2940610,52363,247439,8243876,23.67,7.63
Tender_9548,3343962,1368486,1538391,554961,222639,7028439,41.33,5.87
Tender_9549,9903545,4722043,1801066,577232,114738,17118624,54.33,4.57
Tender_9550,1412176,1349395,2436570,649243,82647,5930031,43.0,5.7
Tender_9551,9384449,3746575,1288011,317014,449432,15185481,27.33,7.27
Tender_9552,1323369,1356099,2561527,109534,488323,5838852,45.67,5.43
Tender_9553,2933300,2542487,205410,463082,73814,6218093,55.33,4.47
Tender_9554,8704315,3906713,1228565,188657,112208,14140458,37.0,6.3
Tender_9555,314848,2889680,1416748,509073,324407,5454756,40.33,5.97
Tender_9556,1342859,2121106,1905215,652288,51833,6073301,28.0,7.2
Tender_9557,9655329,3508727,2343605,279899,452862,16240422,21.67,7.83
Tender_9558,1617319,3544373,2362149,97091,431324,8052256,37.33,6.27
Tender_9559,8057733,3505301,1201644,919784,171739,13856201,19.0,8.1
Tender_9560,8082574,4800034,2113340,402392,213924,15612264,39.33,6.07
Tender_9561,682138,166289,547351,537893,275278,2208949,52.33,4.77
Tender_9562,1544237,1465441,1133057,675856,296697,5115288,40.0,6.0
Tender_9563,9853277,4769779,2693906,897559,411356,18625877,27.33,7.27
Tender_9564,9025267,2672294,930989,842352,429287,13900189,49.33,5.07
Tender_9565,3335991,3535907,1532977,981296,437743,9823914,36.0,6.4
Tender_9566,8378534,945742,357199,458812,128279,10268566,53.67,4.63
Tender_9567,7968746,2515121,785370,374363,95583,11739183,38.33,6.17
Tender_9568,2140249,3174397,106214,293725,223634,5938219,28.67,7.13
Tender_9569,7859666,2758653,245896,625890,146210,11636315,33.33,6.67
Tender_9570,5837955,2387610,1218406,628364,196117,10268452,56.67,4.33
Tender_9571,6984358,3213487,1494010,520390,61888,12274133,47.33,5.27
Tender_9572,8527136,717628,569656,852978,351760,11019158,34.0,6.6
Tender_9573,8903214,1041721,1374698,251149,168557,11739339,40.67,5.93
Tender_9574,5728564,4181705,2183058,267812,420406,12781545,32.0,6.8
Tender_9575,9611790,2979462,789592,348676,330487,14060007,24.67,7.53
Tender_9576,7542126,2768433,2345097,794341,173288,13623285,26.0,7.4
Tender_9577,6856363,4982255,1346969,443637,494439,14123663,54.0,4.6
Tender_9578,7529122,3186615,978720,218639,236970,12150066,44.0,5.6
Tender_9579,2261635,4423305,1693942,221684,119834,8720400,35.0,6.5
Tender_9580,2793415,1917243,1433770,348665,311089,6804182,51.33,4.87
Tender_9581,1545546,4901400,1870343,793014,499316,9609619,37.67,6.23
Tender_9582,7757818,4525528,2175416,471701,216374,15146837,43.67,5.63
Tender_9583,8408463,1372449,1601673,342899,262178,11987662,47.0,5.3
Tender_9584,4945650,883200,2350289,334412,92544,8606095,38.33,6.17
Tender_9585,4532099,3026348,1679821,181637,286487,9706392,31.67,6.83
Tender_9586,5410957,3792978,2647908,612993,92882,12557718,31.67,6.83
Tender_9587,2018004,233710,2075057,527018,395412,5249201,38.67,6.13
Tender_9588,5997166,3128538,2686615,855933,155832,12824084,49.67,5.03
Tender_9589,6535021,3632515,1126984,863295,350405,12508220,24.0,7.6
Tender_9590,6239043,2671391,1160048,222175,486117,10778774,22.67,7.73
Tender_9591,7745298,3304193,1008638,228957,291009,12578095,42.33,5.77
Tender_9592,4997725,1258917,173152,918049,407781,7755624,41.0,5.9
Tender_9593,3795970,3076957,679313,282940,372380,8207560,32.67,6.73
Tender_9594,8274347,3479998,1942490,154679,413302,14264816,40.33,5.97
Tender_9595,5835470,3785115,2199672,815782,247802,12883841,23.33,7.67
Tender_9596,9056973,1645929,2633135,905874,306476,14548387,45.0,5.5
Tender_9597,3281873,1900156,457079,708545,119031,6466684,35.0,6.5
Tender_9598,5115617,128495,377622,247304,446281,6315319,41.67,5.83
Tender_9599,9141032,4350074,1976812,988068,293212,16749198,30.67,6.93
Tender_9600,1452871,2848446,1342163,58141,283588,5985209,45.33,5.47
Tender_9601,3818200,2796730,1444423,942558,57506,9059417,54.33,4.57
Tender_9602,2640372,2413339,1881749,339072,190692,7465224,35.67,6.43
Tender_9603,9237795,2571257,503115,51961,91655,12455783,34.33,6.57
Tender_9604,2153665,1947955,2677172,56249,145950,6980991,34.0,6.6
Tender_9605,8684901,3552761,2223754,719402,218826,15399644,36.0,6.4
Tender_9606,437030,2614791,1443086,400722,260756,5156385,46.0,5.4
Tender_9607,1790816,2453970,318114,118011,131386,4812297,30.0,7.0
Tender_9608,3235521,4991920,740211,220757,451223,9639632,50.0,5.0
Tender_9609,6341617,1996034,146209,820922,188576,9493358,41.67,5.83
Tender_9610,6101579,4102621,1616290,694419,498030,13012939,34.0,6.6
Tender_9611,8622469,2664435,1148776,320411,470373,13226464,53.0,4.7
Tender_9612,4776051,4162579,207192,604324,317412,10067558,34.33,6.57
Tender_9613,4808288,4953356,1174770,485777,452294,11874485,40.67,5.93
Tender_9614,5516089,203349,2180727,695194,286457,8881816,44.33,5.57
Tender_9615,7706789,4770926,879678,248575,461020,14066988,41.33,5.87
Tender_9616,3374410,4337320,1359497,395125,322938,9789290,19.0,8.1
Tender_9617,5648169,4075054,1518166,881861,87125,12210375,34.33,6.57
Tender_9618,2985349,3704321,2734791,71165,361568,9857194,28.0,7.2
Tender_9619,6751995,4637647,1991709,362153,367598,14111102,27.67,7.23
Tender_9620,4622648,4696763,1832949,687167,156476,11996003,42.67,5.73
Tender_9621,785600,1804190,2307856,426241,236805,5560692,47.67,5.23
Tender_9622,7702700,4407619,602983,255569,458860,13427731,34.67,6.53
Tender_9623,2013626,2369003,1491402,506703,298823,6679557,48.67,5.13
Tender_9624,5310375,4980128,1333772,730432,136298,12491005,44.67,5.53
Tender_9625,9778893,924183,332673,349564,471318,11856631,33.33,6.67
Tender_9626,1605969,3698836,987850,102210,235530,6630395,47.0,5.3
Tender_9627,3515718,4972950,758679,296339,266302,9809988,42.33,5.77
Tender_9628,2005553,4172032,355021,842797,396120,7771523,50.33,4.97
Tender_9629,896429,1112996,1240896,419082,177538,3846941,27.67,7.23
Tender_9630,4640861,3168017,2911510,217090,307258,11244736,30.33,6.97
Tender_9631,7437315,3770131,1845666,510400,473654,14037166,49.67,5.03
Tender_9632,6434874,3428361,197525,89259,55026,10205045,39.33,6.07
Tender_9633,2600851,1310013,2053095,274073,72998,6311030,51.33,4.87
Tender_9634,8560751,4806701,2044231,755842,316112,16483637,45.33,5.47
Tender_9635,5419189,2636272,2408716,713347,129354,11306878,41.0,5.9
Tender_9636,1129145,4769723,368966,226724,217330,6711888,43.0,5.7
Tender_9637,4600590,347095,2401882,56273,111979,7517819,29.33,7.07
Tender_9638,6169783,3439101,1244739,259545,132958,11246126,34.0,6.6
Tender_9639,7444426,2194587,902525,490240,152322,11184100,40.67,5.93
Tender_9640,4416846,1913308,2579088,711131,328907,9949280,30.67,6.93
Tender_9641,5584956,2923401,2947474,826559,466590,12748980,44.67,5.53
Tender_9642,4894627,842690,998330,130280,82857,6948784,52.33,4.77
Tender_9643,3740934,4506128,2633262,285730,442200,11608254,56.0,4.4
Tender_9644,1327609,3629998,1596087,449576,360425,7363695,36.0,6.4
Tender_9645,3183067,1284507,2764836,925669,255323,8413402,53.33,4.67
Tender_9646,9846690,3494280,1898988,197003,148127,15585088,47.0,5.3
Tender_9647,1142082,2270259,2346866,468987,466055,6694249,32.0,6.8
Tender_9648,4190227,4028404,1135503,282744,273156,9910034,34.33,6.57
Tender_9649,9060782,4208897,1905442,653183,431318,16259622,42.33,5.77
Tender_9650,3160997,4796721,1767541,617711,156296,10499266,35.0,6.5
Tender_9651,7284993,4706173,1514004,296490,392570,14194230,45.0,5.5
Tender_9652,5553571,546091,59799,854975,169243,7183679,33.67,6.63
Tender_9653,1864096,4918373,1477192,576983,274189,9110833,58.0,4.2
Tender_9654,2768433,1821085,1298384,338298,234113,6460313,28.0,7.2
Tender_9655,4482626,3753442,2146822,775690,458678,11617258,39.0,6.1
Tender_9656,7764677,3921304,1626070,245087,427432,13984570,40.33,5.97
Tender_9657,3312254,3305820,2129332,358860,455327,9561593,33.0,6.7
Tender_9658,9812146,3605975,1158183,620944,161603,15358851,36.67,6.33
Tender_9659,9968517,973302,1169038,136792,405189,12652838,20.67,7.93
Tender_9660,2404414,3935063,2785108,207028,322849,9654462,39.0,6.1
Tender_9661,7001235,3932250,1461984,113089,458797,12967355,49.33,5.07
Tender_9662,3959707,1559556,946694,51955,194554,6712466,32.33,6.77
Tender_9663,3472947,609507,393474,639807,304269,5420004,40.67,5.93
Tender_9664,7741250,298762,1081960,684687,292023,10098682,32.0,6.8
Tender_9665,745959,1496179,2147989,417387,283861,5091375,37.33,6.27
Tender_9666,762018,2004417,1799743,333150,173029,5072357,27.67,7.23
Tender_9667,6051655,1038976,2062744,142310,176646,9472331,33.0,6.7
Tender_9668,2234030,2079047,2232450,285280,393447,7224254,29.33,7.07
Tender_9669,1365190,479744,578920,440129,251845,3115828,36.0,6.4
Tender_9670,3862245,1450765,886585,965000,134937,7299532,25.67,7.43
Tender_9671,1594198,517677,1841399,197575,158731,4309580,41.33,5.87
Tender_9672,3295202,283869,796641,483357,198614,5057683,42.0,5.8
Tender_9673,2641773,863274,2912793,182009,143334,6743183,52.0,4.8
Tender_9674,2819039,2434982,2124892,906269,378012,8663194,39.0,6.1
Tender_9675,7583326,2753353,2756464,219584,233640,13546367,45.0,5.5
Tender_9676,7466995,362803,2407110,583696,394102,11214706,53.33,4.67
Tender_9677,1858271,751734,1190308,654608,454292,4909213,48.67,5.13
Tender_9678,6090854,3729651,669451,793712,128486,11412154,37.67,6.23
Tender_9679,9477888,1236078,2707140,585641,332014,14338761,37.0,6.3
Tender_9680,4469286,2468124,900391,146798,362873,8347472,47.0,5.3
Tender_9681,2737932,2592352,2045341,68367,274315,7718307,42.0,5.8
Tender_9682,6024117,2686173,2826809,624962,272493,12434554,22.0,7.8
Tender_9683,1615700,100889,1291989,420462,437554,3866594,39.67,6.03
Tender_9684,1660873,325140,216903,94646,50079,2347641,48.33,5.17
Tender_9685,9281876,366096,1363600,944955,261160,12217687,32.0,6.8
Tender_9686,8151537,2012462,2692948,86575,185328,13128850,45.0,5.5
Tender_9687,5165700,4024874,429122,83412,285609,9988717,48.0,5.2
Tender_9688,3240614,1172879,2041682,818235,432893,7706303,55.67,4.43
Tender_9689,2840019,1190499,350949,945198,227113,5553778,35.0,6.5
Tender_9690,4202418,2643788,1891419,678736,164549,9580910,25.67,7.43
Tender_9691,2215027,3945053,1568899,152527,131584,8013090,49.0,5.1
Tender_9692,9601201,1452297,2068120,813308,231463,14166389,37.67,6.23
Tender_9693,5708882,2637774,2786882,679479,407270,12220287,32.0,6.8
Tender_9694,8710635,1360896,1026556,561918,236444,11896449,50.33,4.97
Tender_9695,3821345,2645839,706005,459940,489229,8122358,42.67,5.73
Tender_9696,1668645,1982999,663755,401828,455112,5172339,49.0,5.1
Tender_9697,3840340,547435,2374181,541085,291444,7594485,36.0,6.4
Tender_9698,3074303,3053621,859497,674017,157373,7818811,33.33,6.67
Tender_9699,8296279,3455860,1866773,361136,341553,14321601,38.33,6.17
Tender_9700,6083122,3599852,511146,173154,118863,10486137,32.0,6.8
Tender_9701,8436068,265433,878144,104031,201017,9884693,22.33,7.77
Tender_9702,640373,2774033,2234087,874240,60650,6583383,30.67,6.93
Tender_9703,3552484,4615600,509561,431756,480886,9590287,46.67,5.33
Tender_9704,5087971,618386,1344022,89345,286318,7426042,24.67,7.53
Tender_9705,683184,4810065,814161,247188,359448,6914046,49.0,5.1
Tender_9706,7623449,1295930,117162,156001,415453,9607995,30.33,6.97
Tender_9707,2167515,1792411,2898486,665768,150363,7674543,29.0,7.1
Tender_9708,9183213,590139,275073,567550,467944,11083919,43.67,5.63
Tender_9709,1767882,343605,599460,830836,247204,3788987,46.67,5.33
Tender_9710,4691438,3442565,2341361,136823,224261,10836448,46.0,5.4
Tender_9711,9172698,4003565,2075156,858761,147633,16257813,33.0,6.7
Tender_9712,6398276,4867410,2805578,135797,450731,14657792,43.67,5.63
Tender_9713,5376633,1548979,1069886,172275,493362,8661135,43.67,5.63
Tender_9714,4039991,4316314,2932490,830060,469149,12588004,39.67,6.03
Tender_9715,6942976,2492585,1243737,528416,491712,11699426,40.33,5.97
Tender_9716,2635332,3394703,72388,736972,496528,7335923,29.0,7.1
Tender_9717,7576768,1782199,898466,56894,315597,10629924,31.67,6.83
Tender_9718,4674873,4960140,1763015,611698,363045,12372771,40.0,6.0
Tender_9719,8932993,2872393,804098,561922,353695,13525101,30.67,6.93
Tender_9720,1980191,2923363,2078132,637852,314718,7934256,35.67,6.43
Tender_9721,9616101,2964874,2681109,833319,334019,16429422,50.0,5.0
Tender_9722,7994655,3309245,1456105,198230,417692,13375927,33.67,6.63
Tender_9723,3380016,2224198,1685041,210606,240061,7739922,29.0,7.1
Tender_9724,2145606,1545285,700163,940245,385854,5717153,42.67,5.73
Tender_9725,8233113,1316175,2478079,295475,221115,12543957,51.0,4.9
Tender_9726,9486558,3380973,1499408,588753,71079,15026771,21.33,7.87
Tender_9727,5473104,111597,684079,398599,238644,6906023,30.0,7.0
Tender_9728,2462135,4566038,587390,399840,450521,8465924,28.0,7.2
Tender_9729,8237584,1063731,1284575,361090,356032,11303012,31.33,6.87
Tender_9730,7449109,3852925,580580,926436,134792,12943842,42.33,5.77
Tender_9731,5076221,3212071,2555900,944109,406743,12195044,29.0,7.1
Tender_9732,2922598,3974731,980253,569657,71505,8518744,36.0,6.4
Tender_9733,8729858,131151,658045,481232,257529,10257815,41.33,5.87
Tender_9734,4447163,1082813,1850870,737916,426580,8545342,27.0,7.3
Tender_9735,6747012,872304,1975463,580607,156516,10331902,51.33,4.87
Tender_9736,9426554,4901651,1132283,323186,179300,15962974,48.0,5.2
Tender_9737,5521665,134506,1436247,536618,305360,7934396,45.67,5.43
Tender_9738,2284636,4338919,690446,448214,81503,7843718,18.0,8.2
Tender_9739,2768032,453525,2937554,554226,252898,6966235,33.0,6.7
Tender_9740,6957953,2450585,264210,378372,389640,10440760,39.33,6.07
Tender_9741,1303540,3935839,2228923,958071,478306,8904679,23.33,7.67
Tender_9742,8378108,2608331,608639,84478,288950,11968506,32.33,6.77
Tender_9743,6108200,4970680,1824232,774063,373633,14050808,32.0,6.8
Tender_9744,9257581,466394,2891489,717732,480507,13813703,27.67,7.23
Tender_9745,6890724,3077940,156605,968801,110663,11204733,27.33,7.27
Tender_9746,2694008,831147,2081088,457070,65114,6128427,30.67,6.93
Tender_9747,7758524,3226795,1509598,258297,194183,12947397,54.0,4.6
Tender_9748,4953462,4464552,2542098,343589,120952,12424653,38.33,6.17
Tender_9749,2896865,2467663,2206599,315076,343388,8229591,48.67,5.13
Tender_9750,1038740,4437262,494334,539894,463925,6974155,44.0,5.6
Tender_9751,1090484,4485462,1920367,58505,220974,7775792,45.67,5.43
Tender_9752,3966414,4355222,2787679,662544,215017,11986876,33.0,6.7
Tender_9753,2206349,1190345,964669,335022,474259,5170644,48.67,5.13
Tender_9754,6782167,3228682,365894,351769,304947,11033459,48.67,5.13
Tender_9755,2238398,4349446,463422,362918,373444,7787628,36.33,6.37
Tender_9756,896237,677923,1882806,237107,341001,4035074,41.0,5.9
Tender_9757,2514969,1651383,157429,568620,301483,5193884,39.33,6.07
Tender_9758,8787962,580598,382360,325158,155214,10231292,35.33,6.47
Tender_9759,1576140,1665201,585424,104653,426661,4358079,31.0,6.9
Tender_9760,2016793,4019452,1257762,551801,128433,7974241,56.33,4.37
Tender_9761,1980101,1473566,109999,475900,464322,4503888,28.33,7.17
Tender_9762,1902187,2843634,845043,492124,112823,6195811,52.0,4.8
Tender_9763,8419270,4353126,1840674,344139,423991,15381200,52.33,4.77
Tender_9764,763156,1126061,278282,362133,492827,3022459,39.33,6.07
Tender_9765,5233654,710235,873798,351608,260265,7429560,42.33,5.77
Tender_9766,542898,2419113,1810626,172854,127889,5073380,36.33,6.37
Tender_9767,5060442,989187,83469,101289,451128,6685515,51.33,4.87
Tender_9768,8528605,3705433,2314675,993411,344657,15886781,34.33,6.57
Tender_9769,9329276,4414920,641320,445763,143299,14974578,24.0,7.6
Tender_9770,8076380,4850317,2022633,177704,161399,15288433,39.33,6.07
Tender_9771,4061646,2951874,2220234,651254,65365,9950373,54.67,4.53
Tender_9772,8186964,411666,516068,224143,460099,9798940,46.33,5.37
Tender_9773,5220586,3483031,1516752,98570,330591,10649530,32.33,6.77
Tender_9774,8763652,3035789,1912901,587836,329517,14629695,42.0,5.8
Tender_9775,1027001,3814176,1552557,869602,399540,7662876,44.33,5.57
Tender_9776,6468542,1689488,2976014,715595,67627,11917266,24.0,7.6
Tender_9777,2476309,1003980,2248720,377190,421781,6527980,40.33,5.97
Tender_9778,2180015,2025779,1211774,837778,170943,6426289,34.67,6.53
Tender_9779,7966806,1556208,2498750,121876,242111,12385751,41.33,5.87
Tender_9780,262797,4611870,2405424,788819,243147,8312057,41.33,5.87
Tender_9781,2354249,2950395,2044247,195163,373323,7917377,53.33,4.67
Tender_9782,980027,842340,1547539,198672,340693,3909271,33.0,6.7
Tender_9783,8581531,2859019,1538386,205109,342628,13526673,32.33,6.77
Tender_9784,4259536,3244035,2703233,88161,284404,10579369,37.67,6.23
Tender_9785,9680832,1260789,719197,979299,95717,12735834,45.0,5.5
Tender_9786,8303945,4833326,2239860,795742,188335,16361208,45.33,5.47
Tender_9787,1142461,4004220,340782,298745,457074,6243282,32.33,6.77
Tender_9788,1539947,2322207,237913,818581,140072,5058720,45.33,5.47
Tender_9789,7183334,1203736,2807123,616885,114530,11925608,24.67,7.53
Tender_9790,4016619,4465179,2498308,567813,371910,11919829,46.33,5.37
Tender_9791,2290934,3382603,930786,767883,138110,7510316,35.33,6.47
Tender_9792,7295784,3548990,504679,503705,172024,12025182,46.33,5.37
Tender_9793,2375790,4086412,2629175,523413,434656,10049446,34.0,6.6
Tender_9794,9911773,4027328,2581770,267635,470887,17259393,45.67,5.43
Tender_9795,5493636,1079000,2801074,763830,485053,10622593,49.67,5.03
Tender_9796,8831070,475644,996303,610554,494198,11407769,41.33,5.87
Tender_9797,1297082,1557166,2198556,814775,473540,6341119,37.0,6.3
Tender_9798,1068865,1726131,2470361,367178,443634,6076169,44.67,5.53
Tender_9799,7774294,1678627,1735121,193877,273480,11655399,48.0,5.2
Tender_9800,8231289,3277201,999644,662895,187110,13358139,39.67,6.03
Tender_9801,2076940,4801639,1574671,815260,252793,9521303,51.0,4.9
Tender_9802,9961369,1349327,1609619,119091,258595,13298001,29.0,7.1
Tender_9803,6836635,4732464,830866,583604,259118,13242687,53.33,4.67
Tender_9804,8517634,3844638,1016712,372242,80456,13831682,30.0,7.0
Tender_9805,7485865,4549080,442316,959421,198437,13635119,54.67,4.53
Tender_9806,8423424,619615,1005326,448866,413296,10910527,33.67,6.63
Tender_9807,4498178,4690147,1061046,850149,243137,11342657,23.33,7.67
Tender_9808,1312331,4865373,1441908,149880,340133,8109625,40.67,5.93
Tender_9809,6951276,3958265,2218242,199349,362513,13689645,36.67,6.33
Tender_9810,6654779,308998,1808892,195060,181216,9148945,40.33,5.97
Tender_9811,1052300,4275876,788249,304428,225273,6646126,33.67,6.63
Tender_9812,6996761,4987754,1736410,656690,179704,14557319,29.0,7.1
Tender_9813,4670861,2694134,2176757,163817,473222,10178791,24.67,7.53
Tender_9814,9396483,4221479,1503518,577939,129587,15829006,38.0,6.2
Tender_9815,5875439,1419030,129339,191916,335955,7951679,28.67,7.13
Tender_9816,9417859,552385,1031089,363774,190602,11555709,44.0,5.6
Tender_9817,8983925,2977462,2306561,828360,428502,15524810,39.0,6.1
Tender_9818,9275972,1214230,1424792,432540,431139,12778673,46.0,5.4
Tender_9819,5014527,849219,2697860,753134,468697,9783437,21.33,7.87
Tender_9820,5435368,4246609,87229,812291,168483,10749980,43.67,5.63
Tender_9821,4659125,3989842,1228638,982959,241605,11102169,43.0,5.7
Tender_9822,2484583,3053709,1179364,151444,284280,7153380,38.33,6.17
Tender_9823,5012954,383617,2376931,828106,469541,9071149,45.33,5.47
Tender_9824,5925051,4623121,1648449,349292,498736,13044649,39.33,6.07
Tender_9825,1177068,3338203,2789273,822447,317411,8444402,39.67,6.03
Tender_9826,4772905,2030061,255074,85467,473352,7616859,49.33,5.07
Tender_9827,8707473,1307917,494833,827158,472366,11809747,24.0,7.6
Tender_9828,8775479,4272613,250002,908753,461716,14668563,32.67,6.73
Tender_9829,6978579,3934161,378926,994326,417515,12703507,27.33,7.27
Tender_9830,5089172,3439843,1752070,481326,326628,11089039,34.67,6.53
Tender_9831,6139748,4818028,2825024,912801,187498,14883099,31.67,6.83
Tender_9832,3926994,2213349,911838,855556,288217,8195954,41.33,5.87
Tender_9833,8623402,1678264,670002,436374,454769,11862811,39.33,6.07
Tender_9834,7294531,1141011,2662484,295916,440858,11834800,29.33,7.07
Tender_9835,9578622,1012276,295389,360181,109021,11355489,55.0,4.5
Tender_9836,5114298,1489623,54837,93785,245202,6997745,42.0,5.8
Tender_9837,5504525,2507784,251104,223538,412603,8899554,45.0,5.5
Tender_9838,1987261,487027,1356539,699427,449683,4979937,32.0,6.8
Tender_9839,3088000,4653670,2901001,942167,195961,11780799,21.67,7.83
Tender_9840,7194002,3345032,740987,239718,108377,11628116,55.0,4.5
Tender_9841,5734752,149024,487209,461806,238700,7071491,30.67,6.93
Tender_9842,3178128,2206236,2628150,982501,368676,9363691,46.67,5.33
Tender_9843,8478956,2159603,2509976,454683,310251,13913469,20.33,7.97
Tender_9844,7171437,3446562,2794920,570272,50872,14034063,41.67,5.83
Tender_9845,7273107,3589559,2298809,941062,390371,14492908,47.67,5.23
Tender_9846,7659421,4548154,2679865,760847,234846,15883133,42.33,5.77
Tender_9847,4183190,4827358,2436902,278270,184054,11909774,32.0,6.8
Tender_9848,2021734,2819096,964424,160713,457501,6423468,26.33,7.37
Tender_9849,5955731,4240910,2541365,493514,94608,13326128,47.33,5.27
Tender_9850,6388296,263127,1674130,524497,165303,9015353,44.0,5.6
Tender_9851,3084855,2482608,2964446,608512,210028,9350449,38.67,6.13
Tender_9852,5501787,1077342,216550,909063,233818,7938560,34.0,6.6
Tender_9853,4727685,984613,2106575,718234,169589,8706696,39.0,6.1
Tender_9854,1740590,4431919,862207,413435,70427,7518578,41.33,5.87
Tender_9855,8021077,3186360,847865,79368,206394,12341064,35.67,6.43
Tender_9856,9244210,2005758,523550,371803,427217,12572538,28.33,7.17
Tender_9857,3770406,2838334,817468,247733,237390,7911331,31.67,6.83
Tender_9858,3262757,3655021,1592917,568895,389179,9468769,34.0,6.6
Tender_9859,1686831,2199939,1808228,967810,169311,6832119,42.33,5.77
Tender_9860,1519432,1153919,2967795,848051,175397,6664594,35.0,6.5
Tender_9861,2738579,2015650,1694406,327037,499843,7275515,30.0,7.0
Tender_9862,6572890,706474,351759,349182,415110,8395415,49.0,5.1
Tender_9863,9240865,3405106,1159280,300458,495753,14601462,46.67,5.33
Tender_9864,2033159,2254778,687976,121937,214963,5312813,29.0,7.1
Tender_9865,9474365,1583027,230532,831518,278607,12398049,31.0,6.9
Tender_9866,7118154,1125379,1661683,677163,270491,10852870,34.67,6.53
Tender_9867,8880760,3757169,581696,517287,420693,14157605,42.33,5.77
Tender_9868,6411175,2135384,522013,775904,243174,10087650,38.33,6.17
Tender_9869,600722,2667877,1157933,431649,477796,5335977,44.0,5.6
Tender_9870,6757594,3438789,200747,321481,289574,11008185,38.67,6.13
Tender_9871,3800303,762522,697664,192338,456076,5908903,33.33,6.67
Tender_9872,5203282,181023,1176286,285158,127071,6972820,37.67,6.23
Tender_9873,5666400,4671631,2467849,658810,273274,13737964,43.0,5.7
Tender_9874,9046335,3848232,2534666,525727,466322,16421282,36.0,6.4
Tender_9875,5919217,2779312,2833710,213332,408379,12153950,53.33,4.67
Tender_9876,7191386,4850910,2222613,588151,147714,15000774,17.0,8.3
Tender_9877,8447506,4471182,2336865,59133,498834,15813520,36.33,6.37
Tender_9878,8334139,3408695,2431518,160434,497200,14831986,39.0,6.1
Tender_9879,1263411,302507,1096525,800096,235721,3698260,34.0,6.6
Tender_9880,221712,3836410,2783083,827371,449443,8118019,55.67,4.43
Tender_9881,5047512,4605512,1276400,839606,266372,12035402,31.33,6.87
Tender_9882,6361782,3594505,2933009,636696,139422,13665414,46.0,5.4
Tender_9883,6517699,2086426,577962,568085,258267,10008439,44.33,5.57
Tender_9884,8670179,4652325,493633,73875,461961,14351973,40.67,5.93
Tender_9885,9504272,814713,2127883,909383,238203,13594454,43.0,5.7
Tender_9886,3280094,1496670,527092,406183,332048,6042087,28.33,7.17
Tender_9887,7486401,2475838,2807016,821661,224410,13815326,46.67,5.33
Tender_9888,4163748,396801,548140,230352,349639,5688680,35.33,6.47
Tender_9889,5279027,2787261,1394382,586357,496211,10543238,53.0,4.7
Tender_9890,3162493,4126152,580290,317145,253633,8439713,32.67,6.73
Tender_9891,5298654,1385120,684857,420942,473867,8263440,50.67,4.93
Tender_9892,3266513,3334712,877345,295440,127360,7901370,39.67,6.03
Tender_9893,3656149,4723725,566564,741230,396123,10083791,57.0,4.3
Tender_9894,6232496,1270676,819628,147214,475730,8945744,40.67,5.93
Tender_9895,3300611,2358035,2305908,172344,222963,8359861,39.0,6.1
Tender_9896,9100502,4367683,2781908,423727,255890,16929710,36.67,6.33
Tender_9897,8922996,2087872,1280883,854250,395523,13541524,37.0,6.3
Tender_9898,8161215,4063002,428153,604813,73365,13330548,35.33,6.47
Tender_9899,394148,2902489,1583383,526317,316928,5723265,36.67,6.33
Tender_9900,475939,833136,2708572,94756,97343,4209746,49.33,5.07
Tender_9901,5768399,3436125,819258,527484,52181,10603447,26.33,7.37
Tender_9902,2476975,537856,1978059,678885,344759,6016534,42.0,5.8
Tender_9903,6059157,3409117,2060763,132704,218952,11880693,29.0,7.1
Tender_9904,1577227,651861,1626795,744573,281456,4881912,41.67,5.83
Tender_9905,3718319,2501926,1546526,754993,478694,9000458,42.67,5.73
Tender_9906,6815925,488441,2890314,325119,466969,10986768,46.67,5.33
Tender_9907,3253300,1880610,1556451,628975,340493,7659829,30.0,7.0
Tender_9908,8187630,2849129,2440212,785178,478152,14740301,55.0,4.5
Tender_9909,3151273,786987,810791,160606,314051,5223708,47.0,5.3
Tender_9910,5694438,3040461,1557763,778040,75893,11146595,24.33,7.57
Tender_9911,9161811,3881394,1092238,756037,55011,14946491,36.33,6.37
Tender_9912,6960977,1960807,699247,872006,210089,10703126,43.0,5.7
Tender_9913,2169886,416093,1167046,247636,234378,4235039,21.0,7.9
Tender_9914,8701847,107604,739252,681924,358379,10589006,48.67,5.13
Tender_9915,3285192,4073735,1381000,593271,313286,9646484,31.0,6.9
Tender_9916,1853093,2554037,1172098,924394,437100,6940722,40.67,5.93
Tender_9917,1293250,3554727,2964439,221144,318060,8351620,38.33,6.17
Tender_9918,4511879,3149403,1914279,658931,356181,10590673,28.67,7.13
Tender_9919,374803,1213418,1548578,588772,154430,3880001,35.67,6.43
Tender_9920,9404113,2438106,2444702,944558,194156,15425635,39.0,6.1
Tender_9921,4784326,4464590,1406444,128257,92042,10875659,38.0,6.2
Tender_9922,8613338,2045723,2029357,709264,363374,13761056,48.33,5.17
Tender_9923,8038992,2610210,1681078,56763,363729,12750772,33.0,6.7
Tender_9924,4540055,4639746,776082,816478,257067,11029428,43.0,5.7
Tender_9925,2799741,1711342,1309039,589801,491586,6901509,47.33,5.27
Tender_9926,7126901,816465,2478310,463623,83503,10968802,38.33,6.17
Tender_9927,2106961,779443,794577,92981,284367,4058329,42.0,5.8
Tender_9928,6021077,2696182,2542869,367921,400430,12028479,53.67,4.63
Tender_9929,5427664,3209697,2330359,331656,265453,11564829,31.0,6.9
Tender_9930,8046102,239390,2663210,710578,201122,11860402,41.33,5.87
Tender_9931,2159628,3461178,1817364,154266,190062,7782498,30.33,6.97
Tender_9932,3058959,2698190,2812206,412987,173936,9156278,23.67,7.63
Tender_9933,1350711,2744006,493269,668103,118080,5374169,50.33,4.97
Tender_9934,6499691,2057532,2237419,284523,367616,11446781,36.67,6.33
Tender_9935,2305968,1886968,1966974,603283,52968,6816161,40.0,6.0
Tender_9936,8122286,2612604,1425367,394514,296504,12851275,21.33,7.87
Tender_9937,6477618,2849555,749728,105739,263512,10446152,52.33,4.77
Tender_9938,7829666,3519324,2226477,946008,219640,14741115,42.0,5.8
Tender_9939,3414006,1377078,2403931,670134,343772,8208921,33.33,6.67
Tender_9940,4245178,2415406,2871578,613789,119524,10265475,44.67,5.53
Tender_9941,3288173,207538,804530,124127,181109,4605477,22.67,7.73
Tender_9942,755010,962481,2217951,598606,422683,4956731,41.33,5.87
Tender_9943,611530,1991248,567314,120862,200067,3491021,37.0,6.3
Tender_9944,7246412,4437073,1917355,344134,435586,14380560,38.0,6.2
Tender_9945,1796603,2948838,217244,663203,329007,5954895,29.33,7.07
Tender_9946,2095112,4792303,732378,445483,360554,8425830,41.67,5.83
Tender_9947,3944008,3733596,1840673,779599,317035,10614911,24.33,7.57
Tender_9948,7493590,2303884,604661,644528,304699,11351362,42.0,5.8
Tender_9949,9489576,3625213,1176865,485231,295453,15072338,21.0,7.9
Tender_9950,5994800,4527248,1368923,333949,463490,12688410,30.0,7.0
Tender_9951,2808209,2500801,2327745,725787,434610,8797152,35.0,6.5
Tender_9952,8078461,4469714,1549546,430986,191070,14719777,44.67,5.53
Tender_9953,4959088,208132,588135,272040,347526,6374921,26.0,7.4
Tender_9954,9253288,4358298,676998,302353,344479,14935416,46.0,5.4
Tender_9955,364407,3109456,1286651,816904,459947,6037365,34.33,6.57
Tender_9956,3031672,1249745,2857836,527668,228943,7895864,56.0,4.4
Tender_9957,3457780,1393364,999701,150165,184173,6185183,36.33,6.37
Tender_9958,4075624,4662792,388002,815232,442371,10384021,31.0,6.9
Tender_9959,6218227,1489969,1863687,383036,331734,10286653,52.33,4.77
Tender_9960,2884234,2627366,1929570,666535,234607,8342312,24.67,7.53
Tender_9961,4224505,4412727,598900,542606,79997,9858735,28.67,7.13
Tender_9962,5552515,4133356,269122,816256,258972,11030221,52.0,4.8
Tender_9963,8866891,2557944,2352716,325048,293354,14395953,43.33,5.67
Tender_9964,4458444,1690075,1013995,884116,401116,8447746,35.33,6.47
Tender_9965,6469002,1292923,2376319,290948,319172,10748364,29.67,7.03
Tender_9966,7467445,1980051,2214454,290521,466543,12419014,41.0,5.9
Tender_9967,4152343,3558363,2222534,249610,85444,10268294,34.0,6.6
Tender_9968,9570269,1485949,1304827,362600,185017,12908662,33.33,6.67
Tender_9969,3799059,4354022,2941572,268004,203785,11566442,42.67,5.73
Tender_9970,8858236,1486409,2806322,884405,278021,14313393,36.0,6.4
Tender_9971,5367670,2728465,1850850,335728,488592,10771305,38.0,6.2
Tender_9972,6764602,2876533,418975,124357,189824,10374291,44.0,5.6
Tender_9973,1245827,2859685,2841101,180223,489373,7616209,34.33,6.57
Tender_9974,7756223,804763,135194,858553,405797,9960530,38.0,6.2
Tender_9975,5038700,908380,2234141,706828,356124,9244173,31.67,6.83
Tender_9976,9984684,2415052,1761328,579710,204527,14945301,42.67,5.73
Tender_9977,1387352,368496,766919,236547,387011,3146325,49.0,5.1
Tender_9978,6795100,3255785,819369,717840,234487,11822581,32.67,6.73
Tender_9979,8961383,4480110,1755556,826598,470607,16494254,42.33,5.77
Tender_9980,2278508,2387912,2795400,993524,359392,8814736,35.0,6.5
Tender_9981,5515135,540681,1394415,430544,361872,8242647,46.33,5.37
Tender_9982,5684331,215816,2604167,920238,129069,9553621,42.33,5.77
Tender_9983,5624476,139402,381957,725351,187531,7058717,24.0,7.6
Tender_9984,7508693,3375173,2564082,157522,337016,13942486,35.33,6.47
Tender_9985,1910037,4075492,1231030,876024,389547,8482130,26.33,7.37
Tender_9986,3446548,2488319,102958,343357,231014,6612196,44.67,5.53
Tender_9987,7388511,4016060,1793404,609724,362175,14169874,24.67,7.53
Tender_9988,1061797,902372,1881098,468847,443318,4757432,34.33,6.57
Tender_9989,5415109,4906518,2670766,824347,424056,14240796,55.0,4.5
Tender_9990,8126749,690863,1129123,772692,401882,11121309,31.33,6.87
Tender_9991,5624723,1365172,619375,312538,485216,8407024,44.0,5.6
Tender_9992,2153600,394800,1419624,78755,398345,4445124,51.0,4.9
Tender_9993,313537,1005321,182718,881090,113873,2496539,37.67,6.23
Tender_9994,5070316,661281,1590107,199600,72203,7593507,42.33,5.77
Tender_9995,3298389,1005032,1453469,225211,278144,6260245,49.67,5.03
Tender_9996,4708950,3751972,1643861,664504,93536,10862823,43.33,5.67
Tender_9997,2500323,1327997,2809223,324891,230282,7192716,40.0,6.0
Tender_9998,5575791,4480211,688218,724777,397180,11866177,27.67,7.23
Tender_9999,9536191,1667858,2479847,576171,169477,14429544,34.0,6.6
Tender_10000,4558390,493595,1930699,300891,473261,7756836,33.0,6.7
